Wwr, Wwr, Wo, Wo, Wo, Wo, Wo, Wo, Wwr, Wwr, Wo, Wo, Wwr, Wwr, Wwr, Wwr, Wwr, Wo, Wwr, Wwr, Mm, Wo, Hh, Hh, Wwr, Hh, Wwr, Wwr, Wwr, Wwr, Wo, Wwr, Wwr, Ww, Ww, Wwr, Wo, Hh, Hh, Hh, Hh, Hh, Hh, Wwr, Wwr, Wwr, Wwr, Wwr, Ww, Ww, Re, Ww, Ww, Gg^Fms, Ww, Wo, Wo, Wo, Wo, Wo, Wo, Wo
Wwr, Wwr, Wwr, Wo, Wo, Wo, Wo, Wo, Wwr, Wwr, Wo, Wwr, Wwr, Wwr, Wwr, Wwr, Wwr, Wo, Wwr, Wwr, Mm, Wo, Hh, Hh, Hh, Hh, Wwr, Wwr, Wwr, Wwr, Wo, Wwr, Wwr, Ww, Ww, Wwr, Wo, Hh, Hh, Hh, Hh, Hh, Hh, Hh, Wwr, Wwr, Wwr, Wwr, Ww, Ww, Re, Gg^Fms, Gg^Fp, Gg^Fms, Ww, Wo, Wo, Wo, Wo, Wo, Wo, Wo
Wo, Wwr, Wo, Wo, Wo, Wo, Wo, Ww, Wo, Wo, Wo, Wwr, Wwr, Wwr, Wwr, Wwr, Wwr, Wwr, Hh, Hh, Mm, Wo, Wo, Wo, Wo, Hh, Wwr, Wwr, Wwr, Wo, Wwr, Wwr, Wwr, Wwr, Wwr, Wwr, Wwr, Wo, Wo, Wo, Wo, Hh, Wwr, Wwr, Ww^Vm, Wwr, Gg^Fms, Gg^Fms, Ww, Ww, Gg^Fms, Re, Ww, Gg^Fds, Gg^Fms, Wo, Ww^Vm, Ww, Ww, Wo, Wo, Wo
Wo, Wo, Wo, Wo, Wo, Wo, Wo, Wo, Wwr, Wwr, Wwr, Wwr, Wwr, Wwr, Wwr, Wwr, Wwr, Wwr, Wwr, Wwr, Hh, Mm, Mm, Wo, Hh, Wo, Wo, Ww^Vm, Wo, Wo, Wwr, Wwr, Wwr, Wwr, Wwr, Wwr, Wwr, Wwr, Wwr, Wwr, Wo, Wo, Wwr, Wwr, Wwr, Gg^Fms, Gg^Fds, Gg^Fms, Ww^Vm, Ww, Ww, Re, Re, Ww, Ww, Wo, Wwr, Wo, Ww, Wo, Wo, Wo
Wo, Ww^Vm, Wwr, Wo, Wo, Wo, Wo, Wo, Wwr, Wwr, Wwr, Wwr, Wwr, Wwr, Wwr, Wwr, Wwr, Hh, Mm, Mm, Mm, Hh, Hh, Mm, Hh, Hh, Wo, Wo, Wwr, Wo, Wwr, Wwr, Wwr, Wwr, Wwr, Wwr, Wwr, Wwr, Wwr, Wwr, Wwr, Wo, Wwr, Wwr, Gg^Fms, Gg^Fds, Gg^Fp, Wo, Wo, Ww, Ww, Ww, Re, Ww, Ww, Wo, Wwr, Wo, Ww^Vm, Wo, Wo, Wo
Re, Wwr, Wwr, Wwr, Wwr, Wo, Ww^Vm, Wo, Wwr, Wwr, Wwr, Wwr, Wwr, Hh, Hh, Hh, Mm, Hh, Hh, Hh, Hh, Mm, Mm, Hh, Hh, Hh, Wwr, Wwr, Wwr, Wwr, Wwr, Wwr, Wwr, Wwr, Wwr, Wwr, Wwr, Wwr, Wwr, Wwr, Wwr, Wo, Wo, Ww^Vm, Wo, Gg^Fms, Wo, Wo, Ww, Wo, Wo, Wo, Re, Ww, Wwr, Ww, Wwr, Wwr, Hh, Wo, Hh, Wo
Re, Wwr, Wo, Wwr, Wo, Wo, Wwr, Wwr, Wwr, Wwr, Wwr, Wwr, Hh, Mm, Hh, Hh, Mm, Hh, Mm, Hh, Mm, Hh, Hh, Hh, Hh, Hh, Wwr, Wwr, Wwr, Wwr, Wo, Wo, Wwr, Wwr, Wwr, Wwr, Tb^Tf, Wwr, Wwr, Wwr, Wwr, Ww, Ww, Wo, Gg^Fms, Wo, Wo, Ww, Ww, Wo, Wwr, Wwr, Wo, Ww, Wo, Wwr, Hh, Hh, Hh, Hh, Hh, Hh
Re, Wwr, Wo, Wo, Wwr, Wwr, Wwr, Wwr, Wwr, Wwr, Wwr, Wwr, Wwr, Wwr, Hh, Wwr, Hh, Mm, Hh, Mm, Hh, Hh, Hh, Hh, Hh, Wwr, Wwr, Wwr, Wwr, Wo, Wwr, Wwr, Wwr, Wwr, Wo, Wo, Wo, Gg^Fms, Wo, Ww, Ww, Ww, Ww, Ww, Ww, Wo, Ww, Ww, Ww, Ww, Re, Wo, Ww, Ww, Wo, Ww^Vm, Hh, Hh, Hh, Hh, Hh, Hh
Wwr, Re, Wo, Wwr, Wwr, Wwr, Wwr, Wwr, Wwr, Wwr, Wwr, Wwr, Wwr, Wwr, Wwr, Wwr, Hh, Hh, Mm, Mm, Hh, Wo, Wo, Wo, Wo, Wo, Wwr, Wwr, Wwr, Wo, Wwr, Wwr, Wwr, Wo, Wwr, Ww, Wwr, Wo, Wwr, Wo, Wo, Ww, Ww, Ww, Ww, Ww, Ww, Wo, Ww, Ww, Re, Wo, Ww, Ww, Wo, Wwr, Wo, Wo, Hh, Hh, Hh, Wo
Wo, Re, Wo, Ce, Ce, Ce, Wwr, Wwr, Wwr, Wwr, Wwr, Wwr, Wwr, Wwr, Wwr, Wwr, Wwr, Wwr, Mm, Wo, Wo, Wo, Wo, Wo, Wo, Ww^Vm, Wwr, Wwr, Wo, Wo, Wwr, Ww, Wwr, Wo, Wwr, Wwr, Wwr, Wwr, Wwr, Wo, Ww^Vm, Wo, Ww, Ww, Ww, Ww, Ww, Wo, Re, Re, Gg^Fms, Wo, Wo, Gg^Fms, Wo, Wo, Hh, Hh, Hh, Hh, Hh, Hh
Wo, Wo, Wo, Ce, 1 Ke, Wwr, Wwr, Wwr, Wwr, Wwr, Wwr, Wwr, Ww^Vm, Wwr, Wwr, Wwr, Wwr, Wwr, Hh, Wo, Wo, Wo, Wo, Wo, Wo, Wo, Wwr, Wwr, Wwr, Ww, Wwr, Wwr, Ww^Vm, Wwr, Wwr, Wwr, Wwr, Wwr, Wwr, Wwr, Wwr^Qhh, Wo, Wo, Ww, Wo, Ww, Ww, Wo, Wo, Ww, Gg^Fds, Gg^Fp, Ww, Wo, Wwr, Hh, Hh, Hh, Wo, Hh, Hh, Hh
Wo, Wwr, Ce, Ce, Wwr, Wwr, Wwr, Wwr, Wwr, Wwr, Wwr, Wo, Wo, Wwr, Wwr, Wwr, Wwr, Wwr, Wwr, Wwr, Wo, Wo, Wo, Wo, Wo, Wo, Wwr, Wwr, Ww, Ww, Ww, Wwr, Gg^Fms, Wo, Wwr, Wwr, Wwr, Wwr, Wwr, Ch^Qhh, 2 Kh^Qhh, Ch^Qhh, Wwr, Wo, Ww, Wo, Wo, Ww, Re, Wo, Gg^Fms, Gg^Fms, Ww, Wwr, Wwr, Hh, Hh, Hh, Hh, Hh, Hh, Hh
Wwr, Re, Wwr, Wwr, Wwr, Wwr, Wwr, Wwr, Ww^Vm, Wo, Wo, Wo, Wo, Wo, Wwr, Wwr, Wwr, Wwr, Wwr, Wo, Wo, Wo, Wo, Wo, Wwr, Wwr, Wo, Wwr, Gg^Fms, Gg^Fp, Gg^Fms, Gg^Fms, Hh, Wo, Wwr, Ww^Vm, Wwr, Wwr, Wwr, Wwr^Qhh, Ch^Qhh, Wwr^Qhh, Wwr, Wwr, Ww, Ww, Ww, Wo, Chw, Wo, Wo, Wo, Wo, Wo, Wwr, Wwr, Wwr, Wo, Hh, Hh, Hh, Wo
Wo, Re, Re, Ww, Ww, Wwr, Wwr, Wwr, Wwr, Wo, Wo, Wo, Wo, Wo, Wo, Wwr, Wwr, Wwr, Wwr, Wwr, Wwr, Hh^Vhh, Wwr, Wwr, Wwr, Wwr, Wo, Wo, Wo, Gg^Fds, Gg^Fds, Wo, Wo, Wo, Wwr, Wwr, Wwr, Wwr, Wwr, Wwr, Wwr, Wwr, Wwr, Wwr, Wwr, Ww, Ww, Re, Ww, Gg^Vht, Gg^Fms, Wo, Wo, Gg^Fms, Wo, Wwr, Wwr, Wwr, Wwr, Hh, Ww, Wo
Ww, Wo, Ww^Vm, Re, Ww, Ww, Ww, Ww, Ww, Gg^Fms, Wwr, Wo, Wo, Ww^Vm, Wwr, Wwr, Wwr, Wwr, Wwr, Wwr, Wo, Wo, Wwr, Wwr, Wwr, Ww, Wwr, Wo, Wo, Gg^Fms, Wo, Wo, Wo, Wo, Wwr, Wwr, Wwr, Wwr, Wwr, Wwr, Wwr, Wwr, Wwr, Wwr, Wwr, Ww^Vm, Re, Re, Ww, Gg^Fms, Gg^Fms, Gg^Fms, Gg^Fms, Ww, Wo, Wo, Wo, Wwr, Wwr, Ww, Ww, Ww
Ww, Wo, Ww, Re, Ww, Ww, Ww, Ww, Ww, Gg^Fms, Wo, Wo, Wo, Wwr, Wwr, Wwr, Wwr, Ww, Wwr, Ww, Wwr, Wo, Wo, Wo, Wo, Wo, Tb^Tf, Tb^Tf, Tb^Tf, Wo, Gg^Fms, Wo, Gg^Fms, Wo, Wwr, Wwr, Wwr, Wwr, Wwr, Wwr, Wwr, Wwr, Wwr, Wwr, Wwr, Wwr, Re, Ww, Ww, Gg^Fp, Gg^Fds, Gg^Fms, Ww, Wo, Wo, Wo, Wo, Wo, Ww, Ww, Ww, Ww
Wo, Wo, Re, Re, Ww, Ww, Ww, Ww, Wo, Wo, Wo, Wo, Wo, Wwr, Wwr, Gg^Fms, Ww, Wo, Wo, Wo, Wo, Wo, Wo, Wo, Wo, Wo, Wo, Tb^Tf, Tb^Tf, Tb^Tf, Ww, Ww^Vm, Ww, Wwr, Wwr, Wwr, Wwr, Wwr, Wwr, Wwr, Wwr, Wwr, Wwr, Wwr, Wwr, Re, Wwr, Gg^Fms, Gg^Fms, Gg^Fds, Gg^Fp, Gg^Fms, Wo, Wo, Tb^Tf, Wo, Ww, Ww, Ww, Ww, Ww, Ww
Wo, Wo, Wo, Re, Re, Ww, Re, Ww, Wo, Wo, Gg^Fms, Wo, Wo, Gg^Fms, Wo, Gg^Fms, Wo, Ww, Ww, Ww, Wo, Wo, Wo, Wo, Wo, Wo, Ww, Tb^Tf, Tb^Tf, Tb^Tf, Ww, Gg^Fms, Ww, Wwr, Wwr, Wwr, Wwr, Wwr, Re, Wwr, Wwr, Wwr, Wwr, Wwr, Wwr, Re, Gg^Fms, Gg^Fds, Gg^Fds, Gg^Vht, Gg^Fms, Gg^Fms, Wo, Tb^Tf, Tb^Tf, Tb^Tf, Tb^Tf, Ww, Ww, Ww, Ww, Ww
Wwr, Wo, Wo, Ww^Vm, Wo, Re, Wo, Re, Ww, Wo, Wo, Wo, Wo, Wo, Wo, Wo, Wo, Ww^Vm, Wo, Wo, Wo, Wo, Wo, Wo, Wo, Ww^Vm, Ww, Ww, Ww, Ww, Ww, Ww, Re, Re, Re, Re, Re, Re, Hh, Re, Re, Wwr, Re, Wwr, Ww^Vm, Re, Ww, Gg^Fms, Re, Gg^Fms, Wo, Gg^Fms, Wo, Tb^Tf, Tb^Tf, Tb^Tf, Ww, Ww, Ww, Ww, Wo, Ww
Wwr, Ww, Ww, Wo, Ww, Wo, Wo, Wwr, Wo, Wo, Wo, Ww, Ww, Gg^Fms, Gg^Fds, Gg^Fms, Ww, Wo, Ww, Ww, Wo, Wo, Gg^Fms, Wo, Wo, Ww, Wo, Wo, Wo, Ww, Re, Re, Wwr, Wwr, Wwr, Wwr, Ww^Vm, Hh, Hh, Hh, Wwr, Re, Wwr, Re, Re, Re, Re, Re, Wo, Wo, Re, Wo, Re, Tb^Tf, Re, Re, Ww, Ww, Ww, Ww, Ww, Ww
Wwr, Gg^Fms, Gg^Fms, Ww, Ww, Wo, Ww, Re, Wo, Ww^Vm, Wo, Ww, Ww, Ww, Ww^Vm, Gg^Fms, Ww, Ww, Ww, Ww, Wo, Ww, Wo, Wo, Ww, Ww, Wo, Wo, Ww, Ww, Re, Wwr, Wwr, Wwr, Wwr, Wwr, Hh, Hh, Hh, Hh, Hh, Wwr, Wwr, Wwr, Wwr, Re, Gg^Fms, Wo, Ww, Gg^Fms, Ww, Re, Ww, Re, Ww, Gg^Fms, Gg^Fp, Gg^Fms, Gg^Fms, Ww, Ww, Ww
Wwr, Gg^Fp, Ww, Ww, Ww, Ww, Ww, Re, Re, Wo, Ww, Ww, Ww, Gg^Fms, Gg^Fp, Ww, Ww, Ww, Ww, Ww, Wo, Ww, Wo, Wo, Ww, Ww, Wo, Wo, Re, Re, Wwr, Wwr, Wwr, Wwr, Wwr, Wwr, Hh, Hh, Hh, Hh, Hh, Wwr, Wwr, Wwr, Wwr, Re, Re, Wo, Gg^Fms, Gg^Fms, Gg^Fds, Gg^Fds, Gg^Fds, Gg^Fms, Gg^Fms, Gg^Fms, Gg^Fms, Gg^Fp, Gg^Fms, Gg^Fms, Ww^Vm, Ww
Wwr, Gg^Fms, Ww, Ww, Ww, Ww, Ww, Ww, Ww, Re, Re, Ww, Re, Re, Re, Ww, Re, Re, Re, Wo, Wo, Wo, Wwr, Wwr, Re, Re, Re, Wo, Ww, Wwr, Wwr, Wwr, Wwr, Wwr, Wwr, Hh, Hh, Hh, Hh, Hh, Hh, Wwr, Wwr, Wwr, Wwr, Wwr, Ww, Wo, Gg^Fms, Ww, Ww, Gg^Fms, Gg^Fms, Ww, Gg^Fms, Gg^Fds, Gg^Fms, Gg^Fp, Gg^Fms, Ww, Gg^Fms, Gg^Fms
