Hd, Hd, Qlf, Qlf, Qlf, Qlf, Qlf, Qlf, Hd, Hd, Qlf, Qlf, Hd, Hd, Hd, Hd, Hd, Qlf, Hd, Hd, Md^Xm, Qlf, Md, Md, Hd, Md, Hd, Hd, Hd, Hd, Qlf, Hd, Hd, Qlf, Qlf, Hd, Qlf, Md, Md, Md, Md, Md, Md, Hd, Hd, Hd, Hd, Hd, Dd, Dd, Rd, Dd, Dd, Gd^Fdw, Dd, Qlf, Qlf, Qlf, Qlf, Qlf, Qlf, Qlf
Hd, Hd, Hd, Qlf, Qlf, Qlf, Qlf, Qlf, Hd, Hd, Qlf, Hd, Hd, Hd, Hd, Hd, Hd, Qlf, Hd, Hd, Md^Xm, Qlf, Md, Md, Md^Xm, Md, Hd, Hd, Hd, Hd, Qlf, Hd, Hd, Qlf, Qlf, Hd, Qlf, Md, Md, Md, Md, Md, Md, Md, Hd, Hd, Hd, Hd, Dd, Dd, Rd, Gd^Fdw, Gd^Fdw, Gd^Fdw, Dd, Qlf, Qlf, Qlf, Qlf, Qlf, Qlf, Qlf
Qlf, Hd, Qlf, Qlf, Qlf, Qlf, Qlf, Dd, Qlf, Qlf, Qlf, Hd, Hd, Hd, Hd, Hd, Hd, Hd, Md, Md, Md^Xm, Qlf, Qlf, Qlf, Qlf, Md, Hd, Hd, Hd, Qlf, Hd, Hd, Hd, Hd, Hd, Hd, Hd, Qlf, Qlf, Qlf, Qlf, Md, Hd, Hd, Hh^Vhh, Hd, Gd^Fdw, Gd^Fdw, Dd, Dd, Gd^Fdw, Rd, Dd, Gd^Fdw, Gd^Fdw, Qlf, Dd^Vda, Dd, Dd, Qlf, Qlf, Qlf
Qlf, Qlf, Qlf, Qlf, Qlf, Qlf, Qlf, Qlf, Hd, Hd, Hd, Hd, Hd, Hd, Hd, Hd, Hd, Hd, Hd, Hd, Md, Md^Xm, Md^Xm, Qlf, Md, Qlf, Qlf, Hh^Vc, Qlf, Qlf, Hd, Hd, Hd, Hd, Hd, Hd, Hd, Hd, Hd, Hd, Qlf, Qlf, Hd, Hd, Hd, Gd^Fdw, Gd^Fdw, Gd^Fdw, Dd^Vdt, Dd, Dd, Rd, Rd, Dd, Dd, Qlf, Hd, Qlf, Dd, Qlf, Qlf, Qlf
Qlf, Hh^Vhh, Hd, Qlf, Qlf, Qlf, Qlf, Qlf, Hd, Hd, Hd, Hd, Hd, Hd, Hd, Hd, Hd, Md, Md^Xm, Md^Xm, Md^Xm, Md, Md, Md^Xm, Md, Md, Qlf, Qlf, Hd, Qlf, Hd, Hd, Hd, Hd, Hd, Hd, Hd, Hd, Hd, Hd, Hd, Qlf, Hd, Hd, Gd^Fdw, Gd^Fdw, Gd^Fdw, Qlf, Qlf, Dd, Dd, Dd, Rd, Dd, Dd, Qlf, Hd, Qlf, Dd^Vda, Qlf, Qlf, Qlf
Rd, Hd, Hd, Hd, Hd, Qlf, Hh^Vhh, Qlf, Hd, Hd, Hd, Hd, Hd, Md, Md, Md, Md^Xm, Md, Md, Md, Md, Md^Xm, Md^Xm, Md, Md, Md, Hd, Hd, Hd, Hd, Hd, Hd, Hd, Hd, Hd, Hd, Hd, Hd, Hd, Hd, Hd, Qlf, Qlf, Dd^Vda, Qlf, Gd^Fdw, Qlf, Qlf, Dd, Qlf, Qlf, Qlf, Rd, Dd, Hd, Dd, Hd, Hd, Md, Qlf, Md, Qlf
Rd, Hd, Qlf, Hd, Qlf, Qlf, Hd, Hd, Hd, Hd, Hd, Hd, Md, Md^Xm, Md, Md, Md^Xm, Md, Md^Xm, Md, Md^Xm, Md, Md, Md, Md, Md, Hd, Hd, Hd, Hd, Hd^Yc, Hd^Yc, Hd, Hd, Hd, Hd, Tb^Tf, Hd, Hd, Hd, Hd, Dd, Dd, Qlf, Gd^Fdw, Qlf, Qlf, Dd, Dd, Qlf, Qlf, Qlf, Qlf, Dd, Qlf, Hd, Md, Md, Md, Md, Md, Md
Rd, Hd, Qlf, Qlf, Hd, Hd, Hd, Hd, Hd, Hd, Hd, Hd, Hd, Hd, Md, Hd, Md, Md^Xm, Md, Md^Xm, Md, Md, Md, Md, Md, Hd, Hd, Hd, Hd, Hd^Yc, Hd, Hd, Hd, Hd, Qlf, Qlf, Qlf, Gd^Fdw, Qlf, Dd, Dd, Dd, Dd^Do, Dd, Dd, Qlf, Dd, Dd, Dd, Dd, Rd, Qlf, Dd, Dd, Qlf, Dd^Vda, Md, Md, Md, Md, Md, Md
Hd, Rd, Qlf, Hd, Hd, Hd, Hd, Hd, Hd, Hd, Hd, Hd, Hd, Hd, Hd, Hd, Md, Md, Md^Xm, Md^Xm, Md, Qlf, Qlf, Qlf, Qlf, Qlf, Hd, Hd, Hd, Hd^Yc, Hd, Hd, Hd, Qlf, Hd, Dd, Hd, Qlf, Hd, Qlf, Qlf, Dd, Dd, Dd, Dd, Dd^Dc, Dd, Dd^Yc, Dd, Dd, Rd, Qlf, Dd, Dd, Qlf, Hd, Qlf, Qlf, Md, Md, Md, Qlf
Qlf, Rd, Qlf, Ce, Ce, Ce, Hd, Hd, Hd, Hd, Hd, Hd, Hd, Hd, Hd, Hd, Hd, Hd, Md^Xm, Qlf, Qlf, Qlf, Qlf, Qlf, Qlf, Hh^Vhh, Hd, Hd, Hd^Yc, Hd^Yc, Hd, Dd, Hd, Qlf, Hd, Hd, Hd, Hd, Hd, Qlf, Dd^Vda, Qlf, Dd, Dd, Dd, Dd, Dd, Dd^Yc, Rd, Rd, Gd^Fdw, Qlf, Qlf, Gd^Fdw, Qlf, Qlf, Md, Md, Md, Md, Md, Md
Qlf, Qlf, Qlf, Ce, 1 Ke, Hd, Hd, Hd, Hd, Hd, Hd, Hd, Hh^Vc, Hd, Hd, Hd, Hd, Hd, Md, Qlf, Qlf, Qlf, Qlf, Qlf, Qlf, Qlf, Hd, Hd, Hd, Dd, Hd, Hd, Dd^Vda, Qlf, Hd, Hd, Hd, Hd, Hd, Hd, Hd, Qlf, Qlf, Dd, Qlf, Dd, Dd, Dd^Yc, Rd^Yc, Dd, Gd^Fdw, Gd^Fdw, Dd, Qlf, Hd, Md, Md, Md, Qlf, Md, Md, Md
Qlf, Hd, Ce, Ce, Hd, Hd, Hd, Hd, Hd, Hd, Hd, Qlf, Qlf, Hd, Hd, Hd, Hd, Hd, Hd, Hd, Qlf, Qlf, Qlf, Qlf, Qlf, Qlf, Qlf, Hd, Dd, Dd, Dd, Hd, Gd^Fdw, Qlf, Hd, Hd, Hd, Hd, Hd, Ch, 2 Kh, Ch, Hd, Qlf, Dd, Qlf, Qlf, Dd, Rd, Dd^Yc, Gd^Fdw, Gd^Fdw, Dd, Hd, Hd, Md, Md, Md, Md, Md, Md, Md
Hd, Rd, Hd, Hd, Hd, Hd, Hd, Hd, Hh^Vhh, Qlf, Qlf, Qlf, Qlf, Qlf, Hd, Hd, Hd, Hd, Hd, Qlf, Qlf, Qlf, Qlf, Qlf, Hh, Hh, Qlf, Hd, Gd^Fdw, Gd^Fdw, Gd^Fdw, Gd^Fdw, Hd, Qlf, Hd, Dd^Do, Hd, Hd, Hd, Hd, Ch, Hd, Hd, Hd, Dd, Dd, Dd, Qlf, Ch, Qlf, Qlf, Qlf, Qlf, Qlf, Qlf, Hd, Hd, Qlf, Md, Md, Md, Qlf
Qlf, Rd, Rd, Dd, Dd, Hd, Hd, Hd, Hd, Qlf, Qlf, Qlf, Qlf, Qlf, Qlf, Hd, Hd, Hd, Hd, Hd, Hd, Hh^Vhh, Hh, Hh, Hh, Hh, Qlf, Qlf, Qlf, Gd^Fdw, Gd^Fdw, Qlf, Qlf, Qlf, Hd, Hd, Hd, Hd, Hd, Hd, Hd, Hd, Hd, Hd, Hd, Dd, Dd, Rd, Dd, Dd^Vda, Gd^Fdw, Qlf, Qlf, Gd^Fdw, Qlf, Hd, Hd, Hd, Hd, Md, Dd, Qlf
Dd, Qlf, Dd^Vdt, Rd, Dd, Dd, Dd, Dd, Dd, Gd^Fdw, Hd, Qlf, Qlf, Hh^Vhh, Hd, Hd, Hd, Hd, Hd, Hd, Qlf, Qlf, Hh, Hh, Hh, Dd, Qlf, Qlf, Qlf, Gd^Fdw, Qlf, Qlf, Qlf, Qlf, Hd, Hd, Hd, Hd, Hd, Hd, Hd, Hd, Hd, Hd, Hd, Dd^Vdt, Rd, Rd, Dd, Gd^Fdw, Gd^Fdw, Gd^Fdw, Gd^Fdw, Dd, Qlf, Qlf, Qlf, Hd, Hd, Dd, Dd, Dd
Rb, Qlf, Dd, Rd, Dd, Dd, Dd^Dc, Dd, Dd, Gd^Fdw, Qlf, Qlf, Qlf, Hd, Hd, Hd, Hd, Dd, Hd, Dd, Hh, Qlf, Qlf, Qlf, Qlf, Qlf, Tb^Tf, Tb^Tf, Tb^Tf, Qlf, Gd^Fdw, Qlf, Gd^Fdw, Qlf, Hd, Hd, Hd, Hd, Hd, Hd, Hd, Hd, Hd, Hd, Hd, Hd, Rd, Dd, Dd, Gd^Fdw, Gd^Fdw, Gd^Fdw, Dd, Qlf, Qlf, Qlf, Qlf, Qlf, Dd, Dd, Dd, Dd
Qlf, Qlf, Rd, Rd, Dd, Dd, Dd, Dd, Qlf, Qlf, Qlf, Qlf, Qlf, Hd, Hd, Gd^Fdw, Dd, Dd^Yc, Dd^Yc, Dd^Yc, Dd^Yc, Qlf, Qlf, Qlf, Qlf, Qlf, Qlf, Tb^Tf, Tb^Tf, Tb^Tf, Dd, Dd^Vda, Dd, Hd, Hd, Hd, Hd, Hd, Hd, Hd, Hd, Hd, Hd, Hd, Hd, Rd, Hh, Gd^Fdw, Gd^Fdw, Gd^Fdw, Gd^Fdw, Gd^Fdw, Qlf, Qlf, Tb^Tf, Qlf, Dd, Dd, Dd, Dd, Dd, Dd
Qlf, Qlf, Qlf, Rd, Rd, Dd, Rd, Dd, Qlf, Qlf, Gd^Fdw, Qlf, Qlf, Gd^Fdw, Qlf, Gd^Fdw, Qlf, Dd, Dd, Dd, Dd^Yc, Qlf, Qlf, Qlf, Qlf, Qlf, Dd, Tb^Tf, Tb^Tf, Tb^Tf, Dd, Gd^Fdw, Dd, Hd, Hd, Hd, Hd, Hd, Rd, Hd, Hd, Hd, Hd, Hd, Hd, Rd, Gd^Fdw, Gd^Fdw, Gd^Fdw, Dd^Do, Gd^Fdw, Gd^Fdw, Qlf, Tb^Tf, Tb^Tf, Tb^Tf, Tb^Tf, Dd, Dd, Dd, Dd, Dd
Hd, Qlf, Qlf, Dd^Vda, Qlf, Rd, Qlf, Rd, Dd, Qlf, Qlf, Qlf, Qlf, Qlf, Qlf, Qlf, Qlf, Dd^Vdt, Qlf, Qlf, Qlf, Qlf, Qlf, Qlf, Qlf, Dd^Vda, Dd, Dd, Dd, Dd, Dd, Dd, Rd, Rd, Rd, Rd, Rd, Rd, Md, Rd, Rd, Hd, Rd, Hd, Hh^Vhh, Rd, Dd, Gd^Fdw, Rd, Gd^Fdw, Qlf, Gd^Fdw, Qlf, Tb^Tf, Tb^Tf, Tb^Tf, Dd, Dd, Dd, Dd, Qlf, Dd
Hd, Dd, Dd, Qlf, Dd, Qlf, Qlf, Qlf, Qlf, Qlf, Qlf, Dd, Dd, Gd^Fdw, Gd^Fdw, Gd^Fdw, Dd, Qlf, Dd, Dd, Qlf, Qlf, Gd^Fdw, Qlf, Qlf, Dd, Qlf, Qlf, Qlf, Dd, Rd, Rd, Hd, Hd, Hd, Hd, Mm^Vc, Md, Md, Md, Hd, Rd, Hd, Rd, Rd, Rd, Rd, Rd, Qlf, Qlf, Rd, Qlf, Rd, Tb^Tf, Rd, Rd, Dd, Dd, Dd, Dd, Dd, Dd
Hd, Gd^Fdw, Gd^Fdw, Dd, Dd, Qlf, Dd, Rd, Qlf, Dd^Vda, Qlf, Dd, Dd, Dd, Dd^Vda, Gd^Fdw, Dd, Dd, Dd, Dd, Qlf, Dd, Qlf, Qlf, Dd, Dd, Qlf, Qlf, Dd, Dd, Rd, Hd, Hd, Hd, Hd, Hd, Md, Md, Md, Md, Md, Hd, Hd, Hd, Hd, Rd, Gd^Fdw, Qlf, Dd, Gd^Fdw, Dd, Rd, Dd, Rd, Dd, Gd^Fdw, Gd^Fdw, Gd^Fdw, Gd^Fdw, Dd, Dd, Dd
Hd, Gd^Fdw, Dd, Dd, Dd, Dd, Dd, Rd, Rd, Qlf, Dd, Dd, Dd, Gd^Fdw, Gd^Fdw, Dd, Dd, Dd, Dd, Dd, Qlf, Dd, Qlf, Qlf, Dd, Dd, Qlf, Qlf, Rd, Rd, Hd, Hd, Hd, Hd, Hd, Hd, Md, Md, Md, Md, Md, Hd, Hd, Hd, Hd, Rd, Rd, Qlf, Gd^Fdw, Gd^Fdw, Gd^Fdw, Gd^Fdw, Gd^Fdw, Gd^Fdw, Gd^Fdw, Gd^Fdw, Gd^Fdw, Gd^Fdw, Gd^Fdw, Gd^Fdw, Dd^Vda, Dd
Hd, Gd^Fdw, Dd, Dd, Dd, Dd, Dd, Dd, Dd, Rd, Rd, Dd, Rd, Rd, Rd, Dd, Rd, Rd, Rd, Qlf, Qlf, Qlf, Hd, Hd, Rd, Rd, Rd, Qlf, Dd, Hd, Hd, Hd, Hd, Hd, Hd, Md, Md, Md, Md, Md, Md, Hd, Hd, Hd, Hd, Hd, Gg, Qlf, Gd^Fdw, Dd, Dd, Gd^Fdw, Gd^Fdw, Dd, Gd^Fdw, Gd^Fdw, Gd^Fdw, Gd^Fdw, Gd^Fdw, Dd, Gd^Fdw, Gd^Fdw
