Gll^Fmw, Gll^Fmw, Gll^Fmw, Gll^Fmw, Gll^Fmw, Gll^Fmw, Gll^Fmw, Gd, Gd, Gll^Fmw, Gll^Fmw, Gll^Fmw, Gll^Fmw, Gll^Fmw, Gll^Fmw, Gll^Fmw, Gd, Gll^Fmw, Gll^Fmw, Gll^Fp, Gll^Fmw, Gll^Fmw, Gll^Fmw, Gll^Fmw, Gll^Fmw, Ww, Ww, Ww, Ww, Gd, Gll^Fmw, Gd, Gd, Gll^Fmw, Gll^Fmw, Gll^Fmw, Gll^Fmw, Gd, Gll^Fmw, Gll^Fmw, Gll^Fmw, Gd, Gd, Gll^Fmw, Gd, Gd, Gll^Fmw, Gd, Gd, Gll^Fp, Gll^Fp, Gll^Fp
Gll^Fmw, Gll^Fmw, Gll^Fmw, Gll^Fmw, Gll^Fmw, Gll^Fmw, Gd, Gll^Fmw, Gd, Gll^Fmw, Gll^Fmw, Gll^Fmw, Gll^Fmw, Gll^Fmw, Gll^Fmw, Gll^Fmw, Gll^Fmw, Gll^Fmw, Gll^Fmw, Gll^Fmw, Gll^Fmw, Gll^Fmw, Gd, Gll^Fmw, Gll^Fmw, Ww, Ww, Ww, Ww, Gll^Fp, Gd, Gll^Fp, Gd, Gd, Gd, Gd, Gll^Fmw, Gd, Gll^Fmw, Gd, Gll^Fmw, Gll^Fmw, Gll^Fmw, Gd, Gd, Gll^Fmw, Gd, Gll^Fmw, Gll^Fmw, Gll^Fp, Gll^Fp, Gll^Fp
Gll^Fmw, Gll^Fmw, Gll^Fmw, Gll^Fmw, Gll^Fmw, Gll^Fmw, Gd, Gll^Fmw, Gll^Fmw, Gll^Fmw, Gll^Fmw, Gll^Fmw, Gll^Fmw, Gd, Gd, Gll^Fmw, Gd, Gll^Fmw, Gll^Fmw, Gll^Fmw, Gd, Gll^Fmw, Gll^Fmw, Gll^Fmw, Gll^Fmw, Ww, Ww, Gll^Fp, Ww, Gll^Fp, Gll^Fmw, Gll^Fp, Gll^Fp, Gll^Fmw, Gd, Gll^Fmw, Gll^Fmw, Gll^Fmw, Gll^Fmw, Gll^Fmw, Gd, Gll^Fmw, Gll^Fmw, Gll^Fmw, Gd, Gll^Fmw, Gll^Fmw, Gd, Gll^Fmw, Gd, Gll^Fp, Gll^Fp
Gll^Fmw, Gd, Gll^Fmw, Gd, Gll^Fmw, Gd, Gll^Fmw, Gll^Fmw, Gll^Fmw, Gll^Fmw, Gll^Fmw, Gll^Fmw, Gll^Fmw, Gll^Fmw, Gll^Fmw, Gll^Fmw, Gll^Fmw, Gll^Fmw, Gll^Fmw, Gd, Gll^Fmw, Gll^Fmw, Gll^Fmw, Gll^Fmw, Gd, Gll^Fp, Ww, Gd^Vh, Ww, Gd, Gll^Fmw, Gd, Gd, Gll^Fp, Gd, Gd, Gd, Gd, Gd, Gll^Fmw, Gll^Fmw, Gll^Fmw, Gll^Fmw, Gd, Gll^Fmw, Gll^Fmw, Gll^Fmw, Gll^Fmw, Gd, Gd, Gd, Gll^Fp
Re, Gll^Fmw, Gll^Fmw, Gll^Fmw, Gd, Gll^Fmw, Gll^Fmw, Gd, Gll^Fmw, Gd, Gll^Fmw, Gd, Gll^Fmw, Gll^Fmw, Gd, Gd^Fet, Gll^Fmw, Gll^Fmw, Gll^Fmw, Gll^Fmw, Gll^Fmw, Gll^Fmw, Gd, Gll^Fmw, Gd, Gd, Ww, Ww, Ww, Gll^Fp, Gll^Fp, Gd, Gd, Gd, Gd, Gd, Gd, Gd, Gd, Gd, Gd, Gd, Gd, Gd, Gd, Gll^Fmw, Gd, Gll^Fmw, Gd, Gd, Gd, Gll^Fp
Re, Gll^Fp, Gd, Gll^Fmw, Gll^Fmw, Gll^Fmw, Gd, Gll^Fmw, Gll^Fmw, Gll^Fmw, Gll^Fmw, Gll^Fmw, Gll^Fmw, Gll^Fmw, Gll^Fmw, Gd, Gll^Fmw, Gd, Gll^Fmw, Gll^Fmw, Gll^Fmw, Gd, Gd, Gd, Gll^Fp, Ww, Ww, Ww, Gll^Fp, Gll^Fp, Gd, Gd, Gd, Gd, Gd, Gll^Fp, Gd, Gd, Gd, Gd, Gd, Gd^Vh, Gd, Gd, Gd, Gd, Gd, Gd, Gd, Gd, Gd, Gd
Gd, Gll^Fp, Gd, Gd, Gd, Gd, Gd^Vh, Re, Gd, Gll^Fmw, Gd, Gll^Fmw, Gd, Gll^Fmw, Gll^Fmw, Gll^Fmw, Gd, Gll^Fmw, Gd, Gll^Fmw, Gd, Gd, Gd, Gd, Gll^Fp, Ww, Ww, Ww, Ww, Gd, Gd, Gd, Gd, Gd, Gd, Gd, Gd, Gd, Gd, Gd, Gd, Gd, Gd, Gd, Hhd, Hhd, Hhd, Gd, Gd, Gd, Gd, Gd
Gd, Gd, Gll^Fp, Gd, Gd, Gd, Gd, Re, Gd, Gd, Gll^Fp, Gll^Fp, Gd, Gd, Gd, Gll^Fmw, Gd, Gd, Gd, Gd, Gd, Gd, Gd, Gd, Gll^Fp, Gll^Fp, Gll^Fp, Ww, Ww, Gd, Gd, Gd, Gd, Gd, Gd, Gd, Gll^Fp, Gll^Fp, Gd, Gd, Gd, Gd, Gd, Hhd, Md, Md^Fet, Md, Gd, Gd, Gd, Gd, Gd
Gd, Gd, Gd, Gll^Fp, Gd, Gd, Gd, Re, Gd, Gd, Gll^Fp, Gll^Fp, Gll^Fp, Gd, Gd, Gd, Gd, Gd, Gd, Gd, Gd, Gd, Gd, Gd, Gd, Gll^Fp, Gll^Fp, Gd^Vh, Ww, Gd, Gd, Gd, Gd, Gd, Gd, Gd, Gd^Vh, Gll^Fp, Gd, Gd, Gd, Gd, Gd, Hhd, Md, Md, Gd, Gd, Gd, Gll^Fp, Gd^Vh, Gll^Fp
Gd, Gd, Gd, Gll^Fp, Gll^Fp, Gd, Re, Re, Gll^Fp, Gll^Fp, Gll^Fp, Gll^Fp, Gll^Fp, Gll^Fp, Gd, Gd, Gd, Gd, Gd, Gd, Gd, Gd, Gd, Gd, Gd, Gd, Gd, Gd, Ww, Gd, Ww, Ww, Ww, Gd, Gd, Gd, Gll^Fp, Gll^Fp, Gd, Gd, Gd, Gd, Gd, Gd, Hhd, Hhd, Gd, Gd, Gd, Gll^Fp, Gll^Fp, Gll^Fp
Gd, Gd, Gd, Gd, Gd, Gd, Re, Gd, Gll^Fp, Gll^Fp, Gll^Fp, Gll^Fp, Gll^Fp, Gd, Gd, Gd, Gd, Gd, Gd, Gd, Gd, Gd, Gd, Gd, Gd, Gd, Gd, Gd, Gd, Ww, Ww, Ww, Ww, Gd, Gd, Gd, Gd, Gll^Fp, Gll^Fp, Gd, Gd, Gll^Fp, Gd, Gd, Gd, Gd, Gd, Gd, Gd, Gll^Fp, Gll^Fp, Gll^Fp
Gll^Fp, Gll^Fp, Gd, Gd, Gd, Gd, Re, Gd, Gll^Fp, Gll^Fp, Gll^Fp, Gll^Fp, Gd^Vh, Gll^Fp, Gll^Fp, Gll^Fp, Gd, Gd, Gd, Gd, Gd, Gd, Gd, Gd, Gd, Gd, Gd, Gd, Gd, Gd, Gd, Ww, Ww, Ww, Gd, Gd, Gd, Gll^Fp, Gll^Fp, Gll^Fp, Gll^Fp, Gll^Fp, Gd, Gd, Gd, Gd, Gd, Gd, Gd, Gll^Fp, Gd, Gd
Gd, Gd, Gll^Fp, Gll^Fp, Gd, Gd, Gd, Re, Gd, Gll^Fp, Gll^Fp, Gll^Fp, Gd, Gd, Ce, Ce, Ce, Gd, Gd, Gd, Gd, Gd, Gd, Gll^Fp, Gll^Fp, Gll^Fp, Gll^Fp, Gd, Gd, Gd, Ww, Ww, Gd, Gd, Gd, Gd, Gd, Gd, Gll^Fp, Gll^Fp, Gll^Fp, Gd^Vh, Gll^Fp, Gd, Gd, Gd, Gd, Gd, Gll^Fp, Gll^Fp, Gll^Fp, Gll^Fp
Gd, Gd, Gll^Fp, Gd, Gll^Fp, Gll^Fp, Gd, Re, Re, Gd, Gd, Gd, Gd, Gd, Ce, 1 Ke, Ce, Gd, Gd, Gd, Gd, Gd, Gd, Gd, Gll^Fp, Gll^Fp, Gll^Fp, Gd, Gd, Gd, Ww, Ww, Gd, Hhd, Hhd, Gd, Gd, Gd, Gd, Gll^Fp, Gd, Gll^Fp, Gll^Fp, Gd, Gd, Gd, Gd, Gll^Fp, Gll^Fp, Gll^Fp, Gd, Gd
Gd, Gd, Gd, Gll^Fp, Gll^Fp, Gd, Gll^Fp, Gd, Re, Gd, Gd, Gd, Gd, Gd, Gd, Ce, Gd, Gd, Gd, Gd, Gd, Gd, Gd, Gll^Fp, Gd, Gll^Fp, Gd, Gll^Fp, Gd, Gd, Ww, Ww, Gd, Hhd, Gd, Gd, Gd, Gd, Gd, Gll^Fp, Gd, Gll^Fp, Gll^Fp, Gd, Gd, Gd, Gd, Gd, Gll^Fp, Gll^Fp, Gd, Gd
Gd, Gd, Gd, Gll^Fp, Gll^Fp, Gll^Fp, Gd^Vh, Gd, Gd, Re, Re, Ww, Gd, Gd, Gd, Gd, Gd, Gd, Gd, Gd, Gd, Gd, Gd, Gd, Gll^Fp, Gll^Fp, Gll^Fp, Gll^Fp, Gd, Ww, Ww, Gd, Gd, Gd, Gd, Gd, Gd, Gd, Gll^Fp, Gll^Fp, Gd, Gd, Gll^Fp, Gll^Fp, Gd, Gd, Gd, Gll^Fp, Gd^Vh, Gd, Hhd, Gd
Gd, Gd, Gd, Gd, Gll^Fp, Gd, Gll^Fp, Gd, Gd, Gd, Gd, Re, Re, Gd, Gd, Gd, Gd, Gll^Fp, Gd, Gd, Gd, Gd, Gd, Gd, Gd, Gd, Gd, Gd, Gd, Ww, Ww, Gd, Gd, Gd, Gd, Gd, Gd, Gd, Gd, Gll^Fp, Gd, Gd, Gd, Gd, Gll^Fp, Gll^Fp, Gd, Gd, Hhd, Hhd, Md, Hhd
Gd, Gd, Gd, Gd, Gd, Gll^Fp, Gd, Gd, Gd, Gd, Gd, Ww, Re, Gd^Vh, Gd, Gd, Gd, Gd, Gll^Fp, Gd, Gll^Fp, Gd, Gd, Gd, Gd, Gd, Ww, Ww, Ww, Ww, Gd, Gd, Gd, Gd, Gd, Gd, Gd, Gd, Gd, Gll^Fp, Gll^Fp, Gd, Gd, Gd, Gll^Fp, Gd, Gd, Hhd, Hhd, Md, Md^Xm, Md^Xm
Ww, Gd, Gd, Gd, Gd, Gd, Gd, Gd, Hhd, Gd, Gd, Gd, Gd, Re, Gd, Gd, Gd, Gll^Fp, Gll^Fp, Gll^Fp, Gll^Fp, Gd^Vh, Gll^Fp, Ww, Hhd, Ww, Ww, Gd, Gd, Gd, Gd, Gd, Gd, Gd, Gd, Gd, Gd, Gd, Gd, Gd, Gll^Fp, Gd, Gll^Fp, Gd, Gll^Fp, Gd, Gd, Gd, Hhd, Md, Md, Md^Xm
Gd, Ww, Ww, Gd, Gd, Gd, Hhd, Gd, Hhd, Gd, Gd, Gd, Ww, Re, Gd, Gd, Gd, Gd, Gll^Fp, Gll^Fp, Gd, Gll^Fp, Hhd, Ww, Ww, Ww, Ww, Ww, Gd, Gd, Gd, Gll^Fp, Gd, Gd, Gll^Fp, Gd, Gd, Gd, Gd, Gll^Fp, Gd, Gll^Fp, Gd, Gll^Fp, Gd, Gd, Gd, Gd, Gd, Hhd, Md, Hhd
Ww, Ww, Ww, Gd, Hhd, Hhd, Md, Md, Gd, Gd, Gd, Ww, Ww, Re, Re, Gd, Gd, Gll^Fp, Gd, Gll^Fp, Gll^Fp, Hhd, Hhd, Hhd, Ww, Ww, Ww, Ww, Gd^Vh, Gll^Fp, Gd, Gll^Fp, Gll^Fp, Gd, Gll^Fp, Gll^Fp, Gll^Fp, Gd, Gll^Fp, Gll^Fp, Gll^Fp, Gll^Fp, Gd^Vh, Gd, Gd, Gd, Co, Gd, Gd, Hhd, Hhd, Hhd
Ww, Ww, Gd, Gd, Gd, Hhd, Hhd, Hhd, Ww, Ww, Ww, Ww, Ww, Ww, Re, Gd, Gd, Gd, Gll^Fp, Gll^Fp, Gd, Hhd, Hhd, Hhd, Ww, Ww, Ww, Ww, Ww, Gll^Fp, Gll^Fp, Gll^Fp, Gll^Fp, Gll^Fp, Gd, Gll^Fp, Gd, Gd, Gll^Fp, Gd, Gll^Fp, Gll^Fp, Gll^Fp, Gd, Co, Co, 2 Ko, Co, Gd, Gd, Gd, Gd
Gd, Gd, Gd, Gd, Gd, Gd, Gd^Vh, Gd, Ww, Ww, Gd, Ww, Ww, Ww, Re, Gd, Gd, Gd, Gd, Gd, Gd, Hhd, Hhd, Hhd^Vhh, Ww, Ww, Ww, Ww, Gll^Fp, Gll^Fp, Gll^Fp, Gll^Fp, Gll^Fp, Gd, Gd, Gd, Gd, Gll^Fp, Gll^Fp, Gd, Gd, Gd, Gll^Fp, Gll^Fp, Gd, Co, Co, Gd, Gd, Gd, Gd, Gd
Gd, Gd, Gd, Gd, Gd, Gd, Gd, Gd, Ww, Gd, Gd, Ww, Ww, Ww, Re, Gd, Gd, Gd, Gd, Gd, Gd, Gd, Hhd, Hhd, Hhd, Hhd, Hhd, Hhd, Gll^Fp, Gll^Fp, Gd, Gll^Fp, Gll^Fp, Gll^Fp, Gd, Gd, Gd, Gd, Gll^Fp, Gd, Gd, Gd, Gll^Fp, Gll^Fp, Gd, Gd, Gd, Gd, Gd, Gd, Gd, Gll^Fp
Gd, Gd, Gd, Gd, Gd, Gd, Gd, Gd, Ww, Ww, Ww, Gd, Gd, Re, Gd, Gll^Fp, Gd, Gd, Gd, Gd, Gd, Gd, Hhd, Hhd, Hhd, Hhd, Hhd, Hhd, Hhd, Hhd, Gll^Fp, Gll^Fp, Gll^Fp, Gd^Vh, Gll^Fp, Gd, Gd, Gll^Fp, Gd, Gd, Gll^Fp, Gll^Fp, Gll^Fp, Gll^Fp, Gd, Gd, Gd, Gd, Gd, Gd, Gd, Gll^Fp
Gd, Gd, Gd, Gd, Gll^Fp, Gd, Gd, Gd, Gd, Gd, Ww, Ww, Gd, Re, Gd, Gd, Gd, Gd, Gd, Gd, Gd, Gd, Gd, Hhd, Hhd, Hhd, Hhd, Hhd, Hhd, Hhd, Hhd, Gd, Gll^Fp, Gll^Fp, Gd, Gd, Gd, Gd, Gd, Gll^Fp, Gll^Fp, Gll^Fp, Gll^Fp, Gd, Gd, Gd, Gll^Fp, Gd, Gd, Gd, Gd, Gll^Fp
Gd, Gd, Gd, Gd, Gll^Fp, Gll^Fp, Gd, Gd, Gd, Ww, Gd, Gd, Gd^Vh, Re, Gd, Gd, Gd, Gd, Gd, Gd, Gd, Gd, Gd, Hhd, Md, Md, Md, Hhd, Hhd, Hhd, Hhd, Hhd, Gll^Fp, Gd, Gll^Fp, Gd, Gd, Gd, Gd, Gd, Gd, Gd, Gd, Gd, Gd, Gll^Fp, Gd, Gd, Gd, Gd, Gd^Vh, Gll^Fp
Gd, Gd, Gd, Gd, Gd, Gd, Gd, Gd, Gd, Ww, Gd, Gd, Gd, Re, Gd, Gd, Gd, Gd, Gd, Gd, Gd, Gd, Hhd, Md, Md, Md, Hhd, Hhd^Vhh, Hhd, Hhd, Hhd, Hhd, Gll^Fp, Gll^Fp, Gll^Fp, Gll^Fp, Gd, Gd, Gd, Gd, Gd, Gd, Gd, Gll^Fp, Gd, Gd, Gll^Fp, Gll^Fp, Gll^Fp, Gd, Gd, Ww
Gd, Gd, Gd, Gd, Gd, Gd, Gd, Ww, Ww, Ww, Gd, Gd, Gd, Re, Gd, Gd, Gd, Gd, Gd, Gd, Gd, Gd, Hhd, Md, Hhd, Hhd, Hhd, Hhd, Hhd, Gd, Hhd, Hhd, Gll^Fp, Gll^Fp, Gll^Fp, Gll^Fp, Gd, Gd, Gd, Gd, Gd, Gll^Fp, Gll^Fp, Gd^Vh, Gll^Fp, Gd, Gll^Fp, Gll^Fp, Gll^Fp, Gll^Fp, Gd, Ww
Gd, Gd, Gd, Gd, Ww, Gd, Gd, Ww, Gd, Gd, Gd, Gd, Gd, Re, Gd, Gd, Gd, Gd, Gd, Gd, Gd, Hhd, Hhd, Hhd, Hhd, Hhd, Hhd, Hhd, Gd, Gd, Gd, Gd, Gd, Gd, Gd, Gd, Gll^Fp, Gd, Gd, Gll^Fp, Gll^Fp, Gd, Gd, Gll^Fp, Gd, Gd, Gd, Gll^Fp, Gll^Fp, Gd, Ww, Ww
Gd, Gd, Gd, Gd, Ww, Ww, Ww, Ww, Gd, Gd, Gd, Gd, Re, Re, Gd, Gd, Gd, Gd, Gd, Gd, Hhd, Hhd, Hhd, Hhd, Gll^Fp, Gll^Fp, Gd, Gd, Gd, Gd, Gd, Gd, Gll^Fp, Gll^Fp, Gll^Fp, Gd, Gd, Gd, Gd, Gll^Fp, Gd, Gd, Gd, Gll^Fp, Gd, Gd, Gd, Gd, Gd, Gd, Gd, Ww
Gd, Gd, Gd, Gd, Ww, Ww, Ww, Ww, Gd, Gd, Gd, Re, Gd, Gd, Gll^Fp, Gd, Gd, Gll^Fp, Gll^Fp, Gd, Gd, Hhd, Hhd, Gll^Fp, Gll^Fp, Gll^Fp, Gd, Gd, Gd, Gd, Gd, Gd, Gd, Gd, Gd, Gd, Gd, Gd, Gd, Gd, Gd, Gd, Gd, Gd, Gd, Gd, Gd, Gd, Gd, Gd, Gd, Ww
Gd, Gd, Gd, Gd, Ww, Gll^Fp, Ww, Ww, Gd, Gd, Gd, Re, Gll^Fp, Gll^Fp, Gll^Fp, Gll^Fp, Gll^Fp, Gll^Fp, Gll^Fp, Gd^Vh, Gd, Gd, Gd, Gll^Fp, Gd, Gd, Gd, Gd, Gd, Gd, Gd, Gd, Gd, Gd, Gd^Vh, Gd, Gd, Gd, Gd, Gll^Fp, Gll^Fp, Gll^Fp, Gd, Gd, Gd, Gd, Gd, Gd, Gd, Gd, Gd, Ww
Gll^Fp, Gd, Gd, Gd, Ww, Ww, Gll^Fp, Gd^Vh, Gd, Gd, Gd, Re, Gd, Gd^Vh, Gll^Fp, Gll^Fp, Gll^Fp, Gll^Fp, Gll^Fp, Gd, Gd, Gd, Gll^Fp, Gll^Fp, Gd, Gd^Vh, Gd, Gd, Gd, Gd, Gd, Gd, Gd, Gd, Gd, Gd, Gd, Gd, Gd, Gd, Gd, Gd, Gd, Gd, Gd, Gd, Gd, Gd, Gd, Gd, Gd, Ww
Gll^Fp, Gd, Gd, Gd^Vh, Ww, Gll^Fp, Gll^Fp, Gd, Gd, Gd, Gd, Re, Gd, Gll^Fp, Gll^Fp, Gll^Fp, Gll^Fp, Gd, Gll^Fp, Gd, Gd, Gd, Gd, Gd, Gd, Gd, Gd, Gd, Gd, Gd, Gd, Gd, Gd, Gd, Gd, Gd, Hhd, Gd, Gd, Gd, Gd, Gd, Gd, Gd, Gd, Gd, Gd, Gd, Gd^Vh, Gd, Gd, Ww
Gll^Fp, Gll^Fp, Ww, Ww, Gd, Gd, Gd, Gd, Gd, Gd, Gd, Re, Gd, Gd, Gll^Fp, Gd, Gd, Gll^Fp, Gll^Fp, Gd, Gd, Gd, Gd, Gd, Gd, Gd, Gd, Gd, Gd, Gd, Gd, Gd, Gd, Gd, Gd, Hhd, Hhd, Gd, Gd, Gd, Gd, Gd, Gd, Gd, Gd, Gd, Gd, Gd, Ww, Ww, Ww, Ww
Gll^Fp, Gd, Ww, Ww, Gd, Gd, Gd, Gd, Md, Gd, Gd, Re, Re, Gd, Gd, Gd, Gll^Fp, Gll^Fp, Gd, Gd, Gd, Gd, Gd, Gd, Gd, Gd, Gd, Gd, Md, Gd, Hhd, Gd, Gd, Gd, Gd, Hhd, Md, Hhd, Gd, Gd, Gd, Gd, Gd, Gd, Gd, Gd, Co, Co, Ww, Ww, Ww, Ww
Gll^Fp, Ww, Ww, Gd, Gd, Gd, Gd, Md, Md, Gd, Gd, Gd, Gd, Re, Gd, Gd, Gd, Gd, Gd, Gd, Gd, Gd, Gd, Gd, Gd, Gd, Hhd, Md, Md^Xm, Hhd, Hhd, Gd, Gd, Gd, Hhd, Hhd, Md, Hhd, Hhd, Gd, Gd, Gd^Vh, Gd, Gd, Gd, Co, 4 Ko, Co, Gd, Ww, Ww, Ww
Ww, Gd, Gd, Ww, Ww, Gd, Hhd, Md, Hhd, Gd, Gd, Gd, Gd, Re, Re, Gd, Gd, Gd, Gd, Gd^Vh, Gd, Gd, Gd, Gd, Gd, Gd, Hhd, Hhd, Md, Md, Hhd, Gd, Gd^Vh, Hhd, Md, Md, Hhd, Hhd^Fp, Gd, Gd, Gd, Gd, Gd, Gd, Gd, Co, Gd, Gd, Gd, Gd, Ww, Ww
Gd, Ww, Ww, Gd, Ww, Gd, Hhd, Hhd, Gd, Gd, Gd, Gd, Gd, Gd, Gd, Re, Gd, Gd, Gd, Gd, Gd, Gd, Gd, Gd, Gd, Hhd, Hhd, Md, Hhd^Fp, Md, Gd, Gd, Gd, Hhd^Fp, Hhd, Gd, Hhd, Gd, Gd, Gd, Gd, Gd, Gd, Gd, Gd, Gd, Gll^Fp, Gd, Gll^Fp, Ww, Ww, Ww
Ww, Ww, Ww, Ww, Ww, Ww, Gd^Vh, Gd, Gd, Gd, Gd, Gd, Gd, Gll^Fp, Gd, Re, Re, Gd, Gd, Gd, Gd, Gd, Gd, Gd, Gd, Gd^Vh, Gd, Hhd^Fp, Gd, Hhd, Gd, Gd, Gd, Hhd, Gd, Hhd, Hhd, Hhd, Gd, Gd, Gd, Gd, Gd, Gd, Gd, Gd, Gd, Gll^Fp, Gd, Ww, Ww, Ww
Ww, Ww, Gd, Ww, Ww, Ww, Ww, Gd, Gd, Gd, Gll^Fp, Gll^Fp, Gll^Fp, Gd, Gd, Gd, Gd, Re, Gd, Gd, Gd, Gd, Gd, Gd, Gd, Gd, Gd, Gd, Gd, Gd, Gd, Gd, Gd, Gd, Gd, Gd, Gd, Gd, Gd, Gd, Gd, Gd, Gd, Gd, Gd, Gd, Gd, Gd, Gd, Gd^Vh, Ww, Ww
Ww, Ww, Ww, Ww, Ww, Ww, Ww, Gll^Fp, Gd, Gll^Fp, Gll^Fp, Gll^Fp, Re, Gd, Gd, Gd, Re, Re, Re, Re, Re, Gd, Gd, Gd, Gd, Gd, Gd, Gd, Gd, Gd, Gd, Gd, Ww, Ww, Ww, Gd, Gd, Gd, Gd, Gd, Gd, Gd, Gd, Gd, Gd, Gd, Gd, Gll^Fp, Gll^Fp, Gll^Fp, Gll^Fp, Gll^Fp
Gd, Ww, Gd, Gd, Ww, Ww, Ww, Gd, Gd, Gd, Gll^Fp, Re, Gll^Fp, Re, Re, Re, Gll^Fp, Gd, Gd, Gll^Fp, Re, Gd, Gd, Gd, Gd, Gll^Fp, Gd, Gll^Fp, Gll^Fp, Gd, Ww, Ww, Ww, Ww, Ww, Gd, Gd, Gd, Gd, Gd, Ww, Gd, Gd, Gd, Gd, Gd, Gd, Gd, Gll^Fp, Gll^Fp, Gd, Gll^Fp
Gd, Gd, Gd, Gd, Ww, Ww, Gd, Gd, Gd, Gd, Gd, Re, Gd, Gll^Fp, Gd, Gll^Fp, Gd^Vh, Gll^Fp, Gll^Fp, Gll^Fp, Gd, Re, Gd, Gd, Gd, Gd, Gd, Gd, Gll^Fp, Gll^Fp, Gd, Ww, Ww, Ww, Ww, Ww, Ww, Ww, Ww, Ww, Ww, Gll^Fp, Ww, Ww, Ww, Gd, Ww^Bw|r, Gd, Gd, Gd, Ww, Ww
Gll^Fp, Gd, Gd, Gd, Gd, Gd, Gd, Gd, Gd, Gd, Re, Co, Co, Co, Gll^Fp, Gll^Fp, Gll^Fp, Gll^Fp, Gd, Gll^Fp, Gd, Re, Gd, Gd, Gd, Gd, Gll^Fp, Gd, Gd, Ww, Ww, Ww, Ww, Ww, Ww, Ww, Gd, Ww, Gd, Gd, Gll^Fp, Ww, Gd^Vh, Gll^Fp, Ww, Ww, Gd, Ww, Ww, Ww, Ww, Ww
Re, Re, Re, Re, Re, Re, Re, Gd, Gd, Re, Gd, Co, 3 Ko, Co, Gll^Fp, Gd, Gd, Gll^Fp, Gll^Fp, Gd^Vh, Gd, Re, Re, Gd, Gll^Fp, Gll^Fp, Gll^Fp, Gd, Gll^Fp, Gll^Fp, Gll^Fp, Hhd, Ww, Ww, Ww, Ww, Gd, Gd, Gd, Gd, Gll^Fp, Gll^Fp, Gd, Gd, Gd, Gll^Fp, Hh, Gd, Hh, Ww, Ww, Ww
Gd, Gll^Fp, Gd, Gd, Gd, Gd, Gd, Re, Re, Re, Gd, Gll^Fp, Co, Gll^Fp, Gd, Gd, Gll^Fp, Gd, Gd, Gd, Gll^Fp, Gd, Re, Gd, Gd, Gll^Fp, Gd, Gll^Fp, Gll^Fp, Hhd, Hhd, Hhd, Hhd, Ww, Ww, Hhd, Gd, Gd, Gd, Gll^Fp, Gll^Fp, Gd, Gll^Fp, Gd, Gd, Gd, Hh^Fp, Md, Md^Xm, Ww, Ww, Md^Xm
Gll^Fp, Gd, Gd, Gd, Gd, Gd, Gd, Gd, Gd, Gd, Gd, Gll^Fp, Gll^Fp, Gd, Gd, Gd, Gd, Gd, Gd, Gd, Gd, Gd, Re, Gd, Gll^Fp, Gd, Gd, Gd, Gd, Hhd, Md, Hhd, Hhd, Ww, Hhd^Vhh, Hhd, Gd, Gd, Gd, Gll^Fp, Gd, Gll^Fp, Gd, Gd, Gd, Gd, Gd, Hh, Md^Xm, Ww, Ww, Md^Xm
Gd, Gd, Gd, Gd, Gd, Gd, Gd, Gd, Gd^Vh, Gll^Fp, Gll^Fp, Gd, Gll^Fp, Gd, Gd, Gd, Gd, Gd, Gd, Gd, Gd, Gd, Re, Gd, Gd, Gd, Gd, Gd, Md, Hhd, Hhd, Md^Xm, Hhd, Hhd, Hhd, Hhd, Hhd, Gd, Gd, Gd, Gd, Gll^Fp, Gd, Gd, Gll^Fp, Gd, Gd, Md^Xm, Hhd, Ww, Ww, Ww
Gd, Gd, Gd, Gd, Gd, Gd, Gd, Gll^Fp, Gd, Gll^Fp, Gd, Gd, Gd, Gd, Gd, Gd, Gd, Gd, Gd, Gd, Gd, Gd, Gd, Re, Re, Hhd, Hhd, Md, Hhd, Hhd, Hhd, Md, Hhd, Hhd, Hhd, Hhd, Hhd, Gd, Gd, Gd, Gd, Gd, Gd, Gd, Gll^Fp, Gd, Gd, Gd^Vh, Ww, Ww, Ww, Ww
Gd, Gd, Gd, Gd, Gd, Gd, Gd, Gd, Gd, Gll^Fp, Gd, Gd, Gll^Fp, Gd, Gd, Gd, Gd, Gd, Gd, Gd, Gd, Gd, Gd, Gd, Gd, Re, Re, Hhd, Re, Hhd, Hhd, Re, Hhd, Gd, Hhd, Hhd, Gd, Gd, Gd, Gd, Re, Re, Re, Gll^Fp, Re, Gll^Fp, Gd, Gd, Ww, Ww, Ww, Hhd
