Aa, Gd, Gd, Gd, Gd, Aa^Fpa, Gd, Aa, Gd, Aa^Fpa, Aa^Fpa, Gll^Fp, Hh, Mm, Mm, Mm, Ms, Ms, Ms, Ms, Mm, Mm, Mm, Mm, Mm, Mm, Ms, Ha, Ms, Re, Re, Aa^Fpa
Aa, Aa, Gd, Gd, Gd, Gd, Gd, Aa, Gd, Aa^Fpa, Aa^Vha, Gll^Fp, Hh, Mm, Mm, Mm, Ms, Ms, Ms, Ms, Mm, Mm, Mm, Mm, Mm, Mm, Mm, Ms, Ms, Ha, Gd, Re
Aa, Gd, Gd, Gd, Gd, Aa^Fpa, Gd, Gd, Gd, Aa^Fpa, Aa^Fpa, Aa^Fpa, Hh, Hh, Mm, Mm, Ms, Ms, Ms, Ms, Ms, Mm, Mm, Mm, Mm, Mm, Mm, Mm, Ms, Ha, Hh, Aa^Fpa
Gd, Gd, Aa^Fpa, Aa^Fpa, Aa^Fpa, Aa^Fpa, Gd, Aa, Gd, Aa^Fpa, Aa^Fpa, Gll^Fp, Gd, Hh, Hh, Hh, Mm, Ms, Ms, Ms, Ms, Mm, Mm, Mm, Mm, Mm, Mm, Mm, Ms, Ha, Hh, Hh
Gd, Hh, Mm, Hhd, Aa^Fpa, Aa^Fpa, Aa^Fpa, Gd, Gd, Aa^Fpa, Gll^Fp, Gd, Gd, Gd, Gd, Hh, Hh, Ms, Ms, Ms, Ms, Mm, Mm, Mm, Mm, Mm, Mm, Mm, Mm, Ms, Mm, Hh
Aa^Fpa, Hh, Mm, Mm, Hh, Hh, Hh, Aa^Fpa, Aa^Fpa, Aa^Fpa, Gll^Fp, Gd, Gd, Gd, Gd, Gd, Hh, Mm, Ms, Ms, Mm, Mm, Mm, Mm, Mm, Mm, Mm, Mm, Mm, Mm, Mm, Mm
Hh, Hh, Mm, Mm, Mm, Mm, Mm, Hh, Hh, Hh, Hh, Hh, Gd, Gd, Gd, Gd, Gll^Fp, Hh, Mm, Mm, Mm, Mm, Mm, Mm, Hh, Hh, Mm, Mm, Mm, Mm, Mm, Ww
Hh, Mm, Mm, Mm, Mm, Mm, Mm, Mm, Mm, Mm, Hh, Hh, Hh, Gd, Gd, Gd, Gd, Gll^Fp, Hh, Hh, Hh, Mm, Ms, Ha, Ha, Hh, Mm, Mm, Mm, Mm, Ww, Ww
Mm, Mm, Mm, Mm, Mm, Mm, Mm, Mm, Mm, Mm, Mm, Hh, Gd, Gd, Gd, Gd, Gd, Aa^Fpa, Aa^Fpa, Gll^Fp, Aa^Fpa, Ha, Ha, Ha, Ha, Hh, Mm, Mm, Mm, Mm, Ww, Ww
Ms, Mm, Mm, Mm, Mm, Mm, Mm, Mm, Mm, Mm, Mm, Hh, Gd, Gd, Gd, Aa^Fpa, Aa^Fpa, Aa^Fpa, Aa^Fpa, Aa^Vha, Aa^Fpa, Hh, Ha, Ha, Ha, Mm, Mm, Mm, Mm, Mm, Ww, Ww
Re, Hh, Hh, Mm, Mm, Mm, Mm, Mm, Mm, Mm, Mm, Hh, Gd, Gll^Fp, Aa^Fpa, Aa^Fpa, Aa^Fpa, Aa^Fpa, Gd, Aa^Fpa, Hh, Hh, Hh, Ha, Mm, Mm, Hh, Hh, Hh, Hh, Gd, Ai
Re, Hhd^Vhh, Hh, Mm, Mm, Mm, Mm, Ms, Ms, Ms, Mm, Aa^Fpa, Aa^Fpa, Aa^Fpa, Gd, Gd, Gd, Gd, Gd, Gd, Hh, Hh, Hh, Mm, Mm, Ha, Gd, Gd, Gd, Gd, Gd, Gd
Re, Aa^Fpa, Gll^Fp, Hh, Mm, Mm, Mm, Mm, Mm, Mm, Hhd, Aa^Vha, Aa^Fpa, Gd, Aa, Aa, Aa, Gd, Aa, Ha, Hh, Hh, Mm, Hh, Hh, Gd, Gd, Gd, Gd, Gd, 1 Gd, Gd
Re, Gd, Aa^Fpa, Hh, Mm, Mm, Mm, Mm, Mm, Mm, Aa^Fpa, Gd, Gd, Aa, Aa, Aa, Gd, Aa, Aa, Aa, Ha, Hh, Hh, Hh, Gd, Gd, Gd, Gd, Gd, Gd, Re, Re
Re, Gd, Gd, Aa^Fpa, Hhd, Mm, Mm, Mm, Mm, Hh, Gll^Fp, Aa^Fpa, Aa^Fpa, Gd, Aa, Gd, Aa, Aa, Aa, Gd, Gd, Aa^Fpa, Aa^Fpa, Aa^Fpa, Gd, Gd, Aa, Aa, Gd, Re, Gd, Gd
Re, Aa, Aa, Aa, Mm, Mm, Mm, Mm, Mm, Gll^Fp, Gd, Gll^Fp, Aa^Fpa, Aa^Fpa, Gd, Gd, Gd, Gd, Gd, Aa, Gd, Gd, Gd, Gd, Aa, Aa, Aa, Aa, Re, Re, Gd, Gd
Re, Aa, Aa, Aa, Ms, Mm, Mm, Mm, Mm, Aa^Fpa, Gll^Fp, Gll^Fp, Gll^Fp, Aa^Fpa, Aa^Fpa, Aa^Fpa, Aa^Fpa, Aa^Fpa, Aa^Fpa, Gd, Aa, Aa, Aa, Aa, Aa, Aa, Aa, Aa, Re, Gd, Gd, Gd
Re, Aa, Aa, Ha, Ms, Ms, Ms, Ms, Mm, Hh, Aa^Fpa, Aa^Fpa, Aa^Fpa, Aa^Fpa, Aa^Fpa, Aa^Fpa, Aa^Fpa, Aa^Fpa, Aa^Fpa, Aa^Fpa, Gd, Aa, Aa, Aa, Re, Aa, Re, Re, Aa, Gd, Gd, Gd
Re, Aa, Ha, Ms, Ms, Ms, Ms, Ms, Ha, Hh, Gd, Gd, Aa^Fpa, Aa^Fpa, Aa^Fpa, Aa^Fpa, Aa^Fpa, Aa^Fpa, Aa^Fpa, Aa^Fpa, Gd, Aa, Re, Re, Aa, Re, Ha, Ha, Gd, Aa^Fpa, Gd, Gd
Re, Ha, Ms, Ms, Ms, Ms, Ms, Ms, Ms, Ha, Gd, Aa^Fpa, Gd, Gd, Gd, Aa^Fpa, Aa^Fpa, Aa^Fpa, Aa^Fpa, Aa^Vha, Gd, Re, Aa, Aa, Ha, Ms, Ms, Hh, Aa^Fpa, Aa^Fpa, Gd, Aa
Re, Hh, Hh, Ms, Mm, Ms, Ms, Ms, Ms, Ms, Ha, Ha, Ha, Ha, Gd, Gd, Gd, Gd, Aa^Fpa, Aa^Fpa, Gd, Re, Aa, Ha, Ms, Ms, Ms, Hh, Aa^Fpa, Aa^Fpa, Gd, Gd
Re, Ha, Ha, Hh, Mm, Ms, Ms, Ms, Ms, Ms, Ha, Ha, Ha, Ms, Aa, Aa, Aa, Gd, Gd, Gd, Aa, Re, Ha, Ha, Ms, Ms, Mm, Hh, Aa^Fpa, Aa^Fpa, Aa^Fpa, Aa^Fpa
Re, Ha^Vhha, Ha, Ha, Hhd, Ms, Ms, Ms, Ms, Ms, Ms, Ms, Ms, Ha, Ha, Gd, Gd, Gd, Aa, Gd, Re, Re, Ha, Ha, Ms, Mm, Mm, Hh, Aa^Fpa, Aa^Fpa, Gll^Fp, Aa^Fpa
Aa, Re, Ha, Ha, Gd, Ha, Ha, Ms, Ms, Ms, Ms, Ms, Ms, Ha^Vhha, Gd, Aa^Fpa, Aa^Fpa, Gd, Aa, Re, Aa^Fpa, Gd, Ha, Ha, Ha, Hh, Hh, Aa^Fpa, Aa^Fpa, Gll^Fp, Gll^Fp, Gll^Fp
Aa, Re, Aa, Aa, Aa, Gd, Hh, Hh, Ms, Ms, Ms, Mm, Ms, Ms, Hhd, Aa^Fpa, Aa^Fpa, Gd, Gd, Re, Gd, Gd, Aa, Aa, Ha, Gd, Aa^Fpa, Aa^Fpa, Aa^Fpa, Gll^Fp, Gd, Gll^Fp
Aa, Re, Re, Aa, Gd, Aa^Fpa, Gll^Fp, Hh, Mm, Mm, Ms, Ms, Ms, Ms, Ha, Gd, Aa^Fpa, Aa^Fpa, Re, Re, Gd, Ha, Aa, Hh, Ha, Gd, Gd, Aa^Fpa, Aa^Fpa, Gll^Fp, Gll^Fp, Gll^Fp
Gd, Aa, Re, Aa, Gd, Aa^Fpa, Gll^Fp, Hh, Mm, Mm, Ms, Ms, Ms, Ha, Ha, Gd, Gd, Re, Gd, Gd, Ha, Ha, Ha, Hh, Hh, Gd, Gd, Aa^Fpa, Aa^Fpa, Aa^Fpa, Gll^Fp, Gll^Fp
Gd, Gd, Gd, Re, Re, Gd, Aa^Fpa, Aa^Fpa, Hhd, Hhd, Ms, Ms, Ms, Ha, Ha, Aa, Re, Re, Aa, Ha, Ha, Ha, Ms, Mm, Hh, Aa^Fpa, Gd, Gd, Aa^Fpa, Aa^Fpa, Gll^Fp, Gd
Gd, Gd, Aa^Fpa, Aa^Fpa, Gd, Re, Re, Gd, Re, Ha, Ha, Ha, Ha, Ha, Re, Re, Aa, Ms, Ms, Ms, Ms, Ms, Ms, Ms, Hh, Hh, Gd, Gd, Gd, Aa^Fpa, Gll^Fp, Gd
Aa^Fpa, Aa^Fpa, Aa^Vha, Aa^Fpa, Aa^Fpa, Gd, Gd, Re, Gd, Re, Re, Aa^Fpa, Hhd, Re, Ha, Ha, Ha, Ms, Ms, Mm, Mm, Ms, Ms, Mm, Mm, Hh, Gd, Aa, Aa, Aa^Fpa, Gll^Fp, Gll^Fp
Aa^Fpa, Aa^Fpa, Aa^Fpa, Aa^Fpa, Aa^Fpa, Aa^Fpa, Gd, Gd, Aa^Fpa, Gll^Fp, Aa^Fpa, Re, Re, Re, Ha, Ha, Ha, Mm, Mm, Mm, Mm, Mm, Mm, Mm, Ms, Ha, Aa, Gd, Gd, Aa^Fpa, Gll^Fp, Gll^Fp
Gd, Gd, Aa^Fpa, Aa^Fpa, Aa^Fpa, Aa^Fpa, Aa^Fpa, Aa^Fpa, Aa^Fpa, Gd, Re, Re, Gll^Fp, Aa^Fpa, Hh, Hh, Hh, Mm, Mm, Mm, Mm, Mm, Mm, Mm, Ha, Ha, Aa, Gd, Gd, Aa^Fpa, Gll^Fp, Gll^Fp
Gd, Aa, Gd, Aa^Fpa, Aa^Fpa, Aa^Fpa, Aa^Fpa, Aa^Fpa, Gll^Fp, Re, Gd, Gd, Gd, Gll^Fp, Aa^Fpa, Hh, Hh, Mm, Mm, Mm, Mm, Mm, Mm, Hh, Aa^Vha, Aa, Aa, Gd, Aa^Fpa, Aa^Fpa, Gll^Fp, Aa^Fpa
Gd, Aa, Gd, Aa^Fpa, Aa^Fpa, Aa^Fpa, Aa^Fpa, Aa^Fpa, Re, Re, Gd, Gd, Gd, Gll^Fp, Gll^Fp, Hh, Hh, Mm, Mm, Mm, Mm, Mm, Hh, Hh, Aa, Aa, Gd, Gd, Aa^Fpa, Aa^Fpa, Aa^Fpa, Gd
Hh, Ha, Gd, Gd, Gd, Gd, Re, Re, Aa^Fpa, Gll^Fp, Gll^Fp, Gll^Fp, Gll^Fp, Gd, Aa^Fpa, Hh, Hh, Hh, Hh, Mm, Mm, Hh, Hh, Gd, Gd, Aa^Fpa, Aa^Fpa, Aa^Fpa, Aa^Fpa, Aa^Vha, Aa^Fpa, Gd
Hh, Hh, Hh, Aa, Aa, Gd, Re, Aa, Gd, Aa^Fpa, Aa^Fpa, Aa^Fpa, Aa^Fpa, Hh, Hh, Hh, Hh, Hh, Hh, Hh, Hh, Hh, Hh, Hh, Gd, Aa^Fpa, Gll^Fp, Gll^Fp, Gd, Gd, Gd, Gd
Hh, Hh, Hh, Ha, Aa, Re, Aa, Aa, Aa, Gd, Aa^Fpa, Aa^Vha, Aa^Fpa, Hh, Hh, Mm, Hh, Hh, Gll^Fp, Hh, Hh, Ha, Ha, Ha, Gd, Gg, Gg, Aa^Fpa, Aa, Aa, Gd, Gd
Aa^Fpa, Aa^Fpa, Hh, Ha, Re, Re, Aa, Aa, Aa, Gd, Aa^Fpa, Gll^Fp, Gll^Fp, Gll^Fp, Mm, Hh, Hh, Hh, Hh, Hh, Hh, Ms, Ha, Ha, Ww, Hh, Hh, Hh, Ha, Aa, Aa, Aa
Aa^Fpa, Aa^Fpa, Aa^Fpa, Re, Hh, Gd, Aa, Aa, Aa, Aa, Gd, Aa^Fpa, Gll^Fp, Gll^Fp, Hh, Hh, Hh, Hh, Hh, Hh, Hh, Ms, Ms, Ww, Ww, Hh, Mm, Mm, Hh, Gd, Aa, Aa
Gd, Aa^Fpa, Aa^Fpa, Re, Aa^Fpa, Aa^Fpa, Ha, Aa, Aa, Aa, Gd, Aa^Fpa, Aa^Fpa, Gll^Fp, Gll^Fp, Aa^Fpa, Hh, Hh, Hh, Hh, Hh, Mm, Ha^Vhha, Ww, Ww, Ww, Ww, Mm, Hh, Gd, Aa, Aa
Aa, Gd, Re, Re, Gll^Fp, Aa^Fpa, Aa^Fpa, Ha, Aa, Aa, Gd, Gd, Aa^Fpa, Aa^Fpa, Aa^Fpa, Aa^Fpa, Aa^Fpa, Gd, Hh, Hh, Ms, Ms, Ww, Ww, Ww, Ai, Ai, Ha, Gd, Gd, Aa, Aa
Aa, Re, Aa^Fpa, Aa^Fpa, Aa^Fpa, Aa^Fpa, Aa^Fpa, Gd, Aa, Aa, Aa, Aa^Fpa, Aa^Fpa, Aa^Fpa, Aa^Fpa, Aa^Fpa, Gd, Gd, Gd, Ha, Ha, Ha, Ha, Ww, Ai, Ai, Ai, Ha, Aa, Aa, Aa, Aa
