Wo, Wo, Wo, Wo, Wo, Wo, Wo, Wo, Wo, Wo, Wo, Wo, Wo, Wo, Wo, Wo, Wo, Wo, Wo, Wo, Wo, Wo, Wo, Wo, Wo, Wo, Wo, Wo, Wo, Wo, Wo, Wo, Wo, Wo, Wo, Wo, Wo, Wo, Wo, Wo, Wo, Wo, Wo, Wo, Wo, Wo, Wo, Wo, Wo, Wo, Wo, Wo, Wo, Wo, Wo, Wo, Wo, Wo, Wo, Wo, Wo, Wo, Wo, Wo, Wo, Wo, Wo, Wo, Wo, Wo, Wo, Wo
Wo, Wo, Wo, Wo, Wo, Wo, Wo, Wo, Wo, Wo, Wo, Wo, Wo, Wo, Wo, Wo, Wo, Wo, Wo, Wo, Wo, Wo, Wo, Wo, Wo, Wo, Wo, Wo, Wo, Wo, Wo, Wo, Wo, Wo, Wo, Wo, Wwt, Wwt, Wwt, Wo, Wo, Wo, Wo, Wo, Wo, Wo, Wo, Wo, Wo, Wo, Wo, Wo, Wo, Wo, Wo, Wo, Wo, Wo, Wo, Wo, Wo, Wo, Wo, Wo, Wo, Wo, Wo, Wo, Wo, Wo, Wo, Wo
Wo, Wo, Wo, Wo, Wo, Wo, Wo, Wo, Wo, Wo^Vm, Wo, Wo, Wo, Wo, Wo, Wo, Wo, Wo, Wo, Wo, Wwt, Wo, Wwt, Wo, Wo, Wo, Wo, Wo, Wo, Wo, Wo, Wo, Wo, Wo, Wwt, Wwt, Ds, Ds, Ds, Wwt, Wwt, Wwt, Wwt, Wo, Wo, Wo, Wwt, Wwt, Wwt, Wo, Wwt, Wo, Wwt, Wo, Wo, Wo, Wo, Wo, Wo, Wo, Wo, Wo, Wo, Wo, Wo, Wo, Wo, Wo, Wo, Wo, Wo, Wo
Wo, Wo, Wo, Wo, Wo, Wo, Wo, Wo, Wo, Wo, Wo, Wo, Wo, Wo, Wo, Wo, Wo, Wo, Wwt, Wwt, Wwt, Wwt, Wwt, Wwt, Wwt, Wwt, Wwt, Wo, Wo, Wo, Wo, Wo, Wo, Wo, Wwt, Ds, Dd, Ds, Dd, Ds, Ds, Ds, Ds, Wwt, Wwt, Wwt, Wwt, Wo, Wwt, Wwt, Wwt, Wwt, Wwt, Wwt, Wwt, Wwt, Wo, Wo, Wo, Wo, Wo, Wo, Wo, Wo, Wo, Wo, Wo, Wo, Wo, Wo, Wo, Wo
Wo, Wo, Wo, Wo, Wo, Wo, Wo, Wo, Wo, Wo, Wo, Wo, Wo, Wo, Wwt, Wwt, Ds, Wwt, Ds, Wwt, Ds, Wwt, Wwt, Wwt, Wwt, Wwt, Wwt, Wo, Wo, Wo, Wo, Wo, Wo, Wwt, Ds, Ds, Dd, Dd, Gd, Dd, Dd, Dd, Dd, Wwt, Wwt, Wwt, Wwt, Wwt, Wwt, Wwt, Wwt, Wwt, Wwt, Wwt, Wwt, Wo, Wwt, Wo, Wo, Wo, Wo, Wo, Wo, Wo, Wo, Wo, Wo, Wo, Wo, Wo, Wo, Wo
Wo, Wo, Wo, Wo, Wo, Wo, Wo, Wo, Wo, Wo, Wo, Wwt, Wwt, Wwt, Wwt, Ds, Ds, Ds, Ds, Ds, Ds, Ds, Ds, Ds, Ds, Wwt, Wwt, Wwt, Wo, Wo, Wo, Wo, Wo, Wwt, Ds, Dd, Dd, Gd, Gd, Dd, Dd, Dd, Dd, Dd, Wwt, Wwt, Ds, Ds, Ds, Wwt, Ds, Wwt, Ds, Ds, Ds, Wwt, Ds, Wwt, Wo, Wo, Wo, Wo, Wo, Wo, Wo, Wo, Wo, Wo, Wo, Wo, Wo, Wo
Wo, Wo, Wo, Wo, Wo, Wo, Wo, Wo, Wwt, Wwt, Wwt, Wwt, Ds, Ds, Ds, Ds, Dd, Dd, Dd, Dd, Dd, Ds, Dd, Ds, Dd, Ds, Ds, Wwt, Wwt, Wwt, Wo, Wo, Wo, Wwt, Wwt, Ds, Dd, Dd, Dd, Dd, Dd, Dd, Dd, Dd, Ds, Ds, Ds, Wwt, Dd, Ds, Dd, Ds, Dd, Ds, Dd, Ds, Ds, Wwt, Wwt, Wo, Wo, Wo, Wo, Wo, Wo^Vm, Wo, Wo, Wo, Wo, Wo, Wo, Wo
Wo, Wo, Wo, Wo, Wo, Wo, Wo, Wo, Wwt, Ds, Ds, Ds, Cdr, Ds, Dd, Dd, Dd, Dd, Dd, Dd, Dd, Dd^Vdt, Dd, Dd, Dd, Dd, Ds, Wwt, Wwt, Wo, Wo, Wo, Wwt, Wwt, Ds, Ds, Dd, Dd, Hd, Dd, Hd, Dd, Dd, Dd, Dd, Dd, Dd, Dd, Dd, Dd, Dd, Dd, Dd, Dd, Dd, Dd, Dd, Ds, Wwt, Wwt, Wo, Wo, Wo, Wo, Wo, Wo, Wo, Wo, Wo, Wo, Wo, Wo
Wo, Wo, Wo, Wo, Wo, Wo, Wo, Wwt, Ds, Ds, Dd, Dd, Dd, Dd, Dd, Dd, Dd, Dd, Hd, Dd, Dd, Dd, Dd, Dd^Esd, Dd, Ds, Ds, Wwt, Wo, Wo, Wo, Wwt, Wwt, Ds, Ds, Ds, Dd, Dd, Hd, Mdd, Hd, Hd, Hd, Dd, Dd, Dd, Dd, Dd^Vda, Dd, Dd^Esd, Dd, Dd, Dd, Dd, Dd, Dd, Dd^Vdt, Ds, Ds, Wwt, Wwt, Wo, Wo, Wo, Wo, Wo, Wo, Wo, Wo, Wo, Wo, Wo
Wo, Wo, Wo, Wo, Wo, Wo, Wwt, Wwt, Ds, Dd, Ds, Dd, Dd, Dd, Dd, Dd, Dd, Hd, Hd, Hd, Dd, Dd, Dd, Dd, Dd, Ds, Wwt, Wwt, Wwt, Wo, Wwt, Wwt, Wwt, Ds, Dd, Dd, Dd, Dd, Dd, Hd, Hd, Mdd, Hd, Hd, Dd, Dd, Dd, Dd, Dd, Dd, Gd, Gd, Dd, Dd, Dd, Dd, Dd, Dd, Dd, Ds, Ds, Wwt, Wo, Wo, Wo, Wo, Wo, Wo, Wo, Wo, Wo, Wo
Wo, Wo, Wo, Wo, Wo, Wo, Wo, Wwt, Wwt, Ds, Ds, Dd, Dd, Dd, Dd, Dd, Dd, Dd^Do, Hd, Hd, Hd, Dd, Dd, Dd, Dd, Ds, Dd, Ds, Ds, Wwt, Ds, Ds, Ds, Ds, Dd, Dd, Dd^Vdt, Dd, Gd, Dd, Dd, Hd, Dd^Edpp, Dd, Dd, Dd, Gd, Gd, Gd, Gd, Gd, Gd, Dd, Dd, Dd, Dd, Dd, Dd, Dd, Cd, Ds, Wwt, Wwt, Wo, Wwt, Wo, Wo, Wo, Wo, Wo, Wo, Wo
Wo, Wo, Wo, Wo, Wo, Wo, Wo, Wo, Wo, Wwt, Ds, Dd, Dd, Dd, Dd, Dd, Dd, Hd, Dd, Dd, Dd, Dd, Dd, Dd, Dd, Dd^Vda, Dd, Dd, Dd, Ds, Dd, Dd, Dd, Dd, Dd, Dd, Dd, Dd, Dd, Gd, Dd, Dd, Dd, Dd, Dd, Gd, Gd^Fts, Gd^Fts, Gd, Gd, Dd, Dd, Dd, Dd, Dd, Dd, Dd, Dd, Dd, Dd, Dd, Ds, Ds, Wwt, Ds, Wwt, Wo, Wo, Wo, Wo, Wo, Wo
Wo, Wo, Wo, Wo, Wo, Wo, Wo, Wo, Wo, Wwt, Ds, Dd, Dd, Dd, Dd, Dd, Dd, Dd, Dd, Dd, Dd^Esd, Dd, Dd, Dd, Dd, Dd, Dd, Dd, Dd, Dd, Gd, Dd, Dd, Dd, Gd, Dd, Dd, Dd, Dd, Dd, Dd, Gd, Dd, Dd, Gd^Fts, Gd^Fts, Gd^Fts, Gd, Dd, Dd, Dd, Dd, Hd, Hd, Dd, Dd, Dd, Dd, Dd, Dd, Dd, Dd, Dd, Ds, Ds, Wwt, Wo, Wo, Wo, Wo, Wo, Wo
Wo, Wo, Wo, Wo, Wo, Wo, Wo, Wo, Wwt, Wwt, Ds, Dd, Dd, Dd, Dd, Dd, Dd, Dd, Dd, Dd, Dd, Dd, Dd, Dd, Dd, Dd, Dd, Dd, Dd, Gd, Gd, Gd, Gd, Gd, Dd, Dd, Dd, Dd, Dd, Dd, Dd, Gd, Gd, Gd, Gd^Fts, Gd^Fts, Gd, Dd, Dd, Dd, Dd, Dd, Hd, Dd, Hd, Hd, Hd, Dd, Dd, Dd^Edpp, Dd, Dd, Dd, Dd, Ds, Wwt, Wo, Wo, Wo, Wo, Wo, Wo
Wo, Wo, Wo, Wo, Wo, Wo, Wo, Wwt, Wo, Wwt, Ds, Ds, Dd^Esd, Dd, Dd, Dd, Dd^Edpp, Dd^Vda, Dd, Dd, Gd, Dd, Dd, Dd, Dd, Dd, Dd, Dd, Gd, Gd, Gd, Gd, Gd, Gd, Dd, Dd, Dd, Dd, Dd^Esd, Dd, Gd, Gd, Gd^Fts, Gd^Fts, Dd, Dd, Dd, Dd, Dd, Dd, Dd, Dd, Dd, Hd, Hd, Mdd, Hd, Dd, Dd, Dd, Dd, Dd, Dd, Dd, Ds, Wwt, Wo, Wo, Wo, Wo, Wo, Wo
Wo, Wo, Wo, Wo, Wo, Wo, Wo, Wo, Wo, Wwt, Ds, Dd, Dd, Dd, Dd, Dd, Dd, Dd, Dd, Gd, Gd, Gd, Dd, Dd, Dd, Dd, Dd, Dd, Gd, Gd, Dd, Dd, Dd, Gd, Dd, Dd, Dd, Dd, Dd, Dd, Gd, Gd, Gd, Dd, Dd, Dd, Dd, Dd, Dd^Vda, Dd, Dd, Dd, Dd, Hd, Dd, Hd, Dd, Dd, Dd, Dd, Dd, Dd, Dd, Dd, Ds, Wwt, Wwt, Wo, Wo, Wo, Wo, Wo
Wo, Wo, Wo, Wo, Wo, Wo, Wo, Wo, Wwt, Wwt, Ds, Dd, Dd, Dd, Dd^Vdt, Dd, Dd, Dd, Dd, Gd^Fts, Gd^Fts, Gd^Fts, Gd, Dd, Gd, Dd, Dd, Dd, Dd, Dd, Dd, Dd, Dd, Dd, Dd, Dd, Dd, Dd, Dd, Dd, Dd, Gd, Dd, Dd, Dd, Dd, Dd, Dd, Dd, Dd, Dd, Dd, Dd, Dd, Dd, Dd, Dd, Dd^Esd, Dd, Dd^Vda, Dd, Dd, Dd, Dd, Ds, Ds, Wwt, Wo, Wo, Wo, Wo, Wo
Wo, Wo, Wo, Wo, Wo, Wo, Wo, Wo, Wwt, Ds, Wwt, Dd, Dd, Dd, Dd, Dd, Dd, Dd, Dd, Gd, Gd, Gd^Fts, Gd^Fts, Gd, Gd, Gd, Gd, Dd, Dd, Dd, Dd, Dd, Hd, Hd, Dd, Hd, Hd, Dd, Dd, Dd, Dd, Dd, Dd, Dd, Dd, Dd, Dd, Dd, Dd, Dd, Dd, Dd, Dd, Dd, Dd, Dd, Dd, Dd, Dd, Dd, Dd, Dd, Dd, Dd, Ds, Ds, Wwt, Wo, Wo, Wo, Wo, Wo
Wo, Wo, Wo, Wo, Wo, Wo, Wo, Wo, Wwt, Ds, Wwt, Ds, Dd, Dd, Dd, Dd, Dd, Dd, Dd, Dd, Gd, Gd^Fts, Gd^Fts, Gd^Fts, Gd, Gd, Gd, Dd, Dd, Dd^Vda, Dd, Dd, Dd, Hd, Dd, Hd, Hd, Hd, Dd, Dd, Dd, Dd, Dd, Dd, Dd, Dd, Dd, Dd, Hd, Hd, Dd, Dd, Dd, Dd, Gd, Dd, Dd, Dd, Dd, Dd, Dd^Edpp, Dd, Dd, Dd, Ds, Ds, Wwt, Wo, Wo, Wo, Wo, Wo
Wo, Wo, Wo, Wo, Wo, Wo, Wo, Wo, Wwt, Wwt, Ds, Ds, Dd, Dd, Dd, Dd, Dd, Dd, Dd, Gd, Gd^Fts, Gd^Fts, Gd^Fts, Gd^Fts, Dd, Gd, Gd, Dd, Dd, Dd, Dd, Dd, Dd, Hd, Hd, Hd, Mdd, Hd, Dd, Dd, Dd, Dd, Dd, Dd, Dd, Hd, Hd, Dd, Hd, Hd, Dd, Dd, Dd, Gd, Gd, Gd, Dd, Dd, Dd, Dd^Edpp, Dd, Dd, Dd, Dd, Ds, Wwt, Wwt, Wo, Wo, Wo, Wo, Wo
Wo, Wo, Wo, Wo, Wo, Wo, Wo, Wo, Wwt, Wwt, Dd, Dd, Dd, Dd, Dd, Dd, Dd, Dd, Dd, Gd, Gd, Gd^Fts, Gd^Fts, Gd^Fts, Gd, Gd, Dd, Dd, Dd, Dd, Dd, Dd, Dd, Dd, Hd, Mdd, Hd, Dd, Dd, Dd, Dd, Dd, Dd^Vda, Dd, Dd, Hd, Dd, Hd, Dd, Dd, Dd, Dd, Dd, Gd, Gd, Gd, Gd, Dd, Dd, Dd, Dd, Dd, Dd, Dd, Ds, Ds, Wo, Wo, Wo, Wo, Wo, Wo
Wo, Wo, Wo, Wo, Wo, Wo, Wwt, Wwt, Ds, Ds, Dd, Dd, Dd, Dd, Dd, Dd, Dd, Dd, Dd, Dd, Dd, Gd, Gd, Gd, Dd, Dd, Dd, Dd, Dd, Dd, Dd, Dd, Dd, Dd, Dd, Hd, Dd, Dd, Dd, Dd, Dd, Dd, Dd, Dd, Dd, Dd, Dd, Dd, Dd, Dd, Dd, Dd, Dd, Dd, Gd, Gd, Gd^Fts, Dd, Dd, Dd, Dd, Dd^Vdt, Dd, Dd, Ds, Wwt, Wwt, Wo, Wo, Wo, Wo, Wo
Wo, Wo, Wo, Wo, Wo, Wwt, Ds, Ds, Dd, Dd, Dd, Dd, Dd, Dd, Dd, Dd, Dd, Dd, Dd, Dd, Hd, Dd, Dd, Dd, Dd, Dd, Dd, Dd, Dd, Dd, Gd^Eff, Dd, Gd, Dd, Dd, Dd, Dd, Dd, Dd, Dd, Dd, Dd, Dd^Esd, Dd, Dd, Dd, Dd, Dd, Dd, Dd, Dd, Dd, Dd, Dd, Xu^Edb, Gd^Fts, Gd^Fts, Gd, Gd, Dd, Dd, Dd, Dd, Ds, Ds, Wwt, Ds, Wwt, Wo, Wo, Wo, Wo
Wo, Wo, Wo, Wo, Wwt, Wwt, Ds, Dd, Dd, Dd, Dd, Dd, Dd, Dd, Dd, Dd, Dd, Dd, Hd, Hd, Hd, Dd, Dd, Dd, Dd, Dd, Gd, Gd, Gd^Eff, Gd^Eff, Gd^Gvs, Gd^Eff, Gd^Vda, Gd, Dd, Dd, Dd, Dd, Dd, Dd, Dd, Dd, Dd, Dd, Dd, Dd, Gd, Gd, Gd, Dd, Dd, Dd, Dd, Xu^Edb, Uu^Edb, Xu^Edb, Gd, Gd^Fts, Gd, Gd, Dd, Dd, Dd, Dd, Ds, Ds, Ds, Wwt, Wo, Wo, Wo, Wo
Wo, Wo, Wo, Wo, Wo, Wwt, Wwt, Ds, Ds, Dd, Dd, Dd, Dd, Dd, Dd^Vdt, Dd, Dd, Dd, Hd, Hd, Hd, Dd, Dd, Dd, Dd, Dd, Gd^Eff, Gd^Eff, Gd^Gvs, Gd^Gvs, Gd^Gvs, Gd^Gvs, Gd, Gd, Dd, Dd, Dd, Cd, Dd, Dd, Dd, Dd, Dd, Dd, Dd, Dd, Gd, Gd, Gd, Gd, Dd, Dd^Vdt, Dd, Xu^Edb, Uu^Edb, Xu^Edb, Gd, Gd^Fts, Gd, Gd, Gd, Dd, Dd, Dd, Ds, Ds, Wwt, Wwt, Wo, Wo, Wo, Wo
Wo, Wo, Wo, Wo, Wo, Wwt, Wwt, Wwt, Wwt, Dd, Dd, Dd, Dd, Dd, Dd, Dd, Dd, Dd, Dd, Hd, Hd, Dd, Dd, Dd, Dd, Dd, Dd, Gd^Eff, Gd^Eff, Gd^Gvs, Gd^Eff, Gd^Eff, Gd, Gd, Cd, Dd, Dd, Dd, Dd, Dd, Cd, Dd, Hd, Dd, Dd, Dd, Dd, Gd, Gd, Gd, Dd, Dd, Dd, Dd, Dd, Dd, Dd, Gd^Fts, Gd, Gd, Dd, Dd, Dd, Ds, Ds, Ds, Wwt, Wo, Wo, Wo, Wo, Wo
Wo, Wo, Wo, Wo, Wo, Wo, Wwt, Wwt, Wwt, Ds, Dd, Dd, Dd, Dd, Dd, Dd, Dd, Dd, Dd, Dd, Dd, Dd, Dd, Dd, Dd^Esd, Dd, Dd, Dd, Dd, Dd, Dd, Dd, Dd, Dd, Dd, Dd, Cd, Cd, Cd, Hd, Dd, Hd, Hd, Dd^Vda, Dd, Dd, Dd, Dd, Dd, Dd, Dd, Dd, Dd, Dd, Dd, Dd, Dd, Dd, Dd, Gd, Dd, Dd, Dd, Dd, Ds, Wwt, Wo, Wo, Wo, Wo, Wo, Wo
Wo, Wo, Wo, Wo, Wwt, Wwt, Ds, Ds, Ds, Ds, Dd, Dd, Dd, Dd, Dd, Dd, Dd, Dd, Dd, Dd, Dd, Dd, Dd, Dd, Dd, Dd, Dd, Dd, Dd, Dd, Dd, Dd, Dd, Dd, Dd, Dd, Cd, 3 Kd, Cd, Dd, Dd, Hd, Hd, Dd, Dd, Dd, Dd, Dd, Dd, Dd, Dd, Dd, Dd, Dd, Hd, Dd, Dd, Dd, Dd, Dd, Dd, Dd, Dd, Dd, Dd, Wwt, Wwt, Wo, Wo, Wo, Wo, Wo
Wo, Wo, Wo, Wwt, Wwt, Wwt, Ds, Dd, Dd, Dd, Dd, Dd, Gd, Dd, Dd, Dd, Dd, Dd, Dd, Dd, Dd, Dd, Dd, Dd, Dd, Dd, Dd, Dd^Vda, Dd, Dd, Dd, Dd, Dd, Dd, Cd, Dd, Dd, Cd, Dd, Dd, Cd, Dd, Dd, Dd, Dd, Dd^Edpp, Dd, Dd, Dd, Dd, Gd, Dd, Dd, Dd, Dd, Hd, Dd, Dd, Dd, Dd, Dd, Dd^Vdt, Dd, Dd, Ds, Wwt, Wwt, Wo, Wo, Wo, Wo, Wo
Wo, Wo, Wo, Wwt, Wwt, Wwt, Ds, Dd, Dd, Dd, Dd, Dd, Gd, Dd, Gd, Dd, Dd, Dd^Vda, Dd, Dd, Dd, Dd, Dd, Dd, Dd, Dd, Dd, Dd, Dd, Dd, Hd, Hd, Hd, Hd, Dd, Dd, Dd, Dd, Dd, Dd, Dd, Dd, Dd, Dd, Dd, Dd, Dd, Dd, Dd, Gd, Gd, Gd, Dd, Dd, Dd, Hd, Hd, Dd, Dd, Dd, Dd, Dd, Dd, Ds, Ds, Wwt, Wwt, Wo, Wo, Wo, Wo, Wo
Wo, Wo, Wwt, Wwt, Wwt, Wwt, Ds, Dd, Ce, Ce, Ce, Dd, Gd, Gd, Gd, Gd, Gd, Dd, Dd, Dd, Dd^Esd, Dd^Edpp, Dd^Edpp, Dd^Edpp, Dd^Esd, Dd, Dd, Dd, Hd, Hd, Mdd, Mdd, Hd, Dd, Dd, Dd, Dd^Esd, Cd, Dd, Hd, Dd, Dd, Dd, Dd, Dd, Dd, Dd, Dd, Dd, Gd, Gd, Gd^Vc, Gd, Dd, Dd, Hd, Hd, Dd, Dd, Dd, Dd, Dd^Esd, Dd, Dd, Ds, Wwt, Wwt, Wwt, Wo, Wo, Wo, Wo
Wo, Wo, Wo, Wo, Wo, Wwt, Wwt, Ds, Ce, 1 Ke, Ce, Dd, Gd, Dd, Gd, Gd, Gd, Gd, Dd, Dd, Dd, Dd, Dd^Edpp, Dd^Edpp, Dd, Dd, Hd, Hd, Mdd, Hd, Mdd^Xm, Mdd, Hd, Hd, Dd, Dd, Dd, Dd, Dd, Hd, Hd, Hd, Hd, Dd, Dd, Dd, Dd, Dd, Dd, Dd, Gd, Gd, Gd, Dd, Dd, Hd, Dd, Dd, Dd, Dd, Dd, Dd, Dd, Ds, Ds, Wwt, Wwt, Wwt, Wo, Wo, Wo, Wo
Wo, Wo, Wo, Wo, Wo, Wo, Wwt, Ds, Dd, Ce, Dd, Dd, Dd, Gd, Gd, Gd, Gd, Gd, Gd, Dd, Dd, Dd, Dd, Dd, Dd, Dd, Hd, Hd, Mdd, Mdd, Mdd, Mdd, Hd, Hd, Dd, Dd, Dd^Vda, Dd, Dd, Dd, Dd, Hd, Hd, Dd, Dd, Dd^Vda, Dd, Dd, Dd, Dd, Dd, Gd, Dd, Dd, Dd^Esd, Dd, Dd, Dd, Dd^Vda, Dd, Dd, Dd, Ds, Ds, Ds, Wwt, Wo, Wo, Wo, Wo, Wo, Wo
Wo, Wo, Wo, Wo, Wo, Wo, Wwt, Ds, Dd, Dd, Dd, Dd, Dd, Dd, Dd, Gd, Gd, Gd, Dd, Dd, Dd, Dd, Dd, Dd^Vdt, Dd, Dd, Dd, Hd, Hd, Mdd, Hd, Dd, Dd, Dd, Gd, Dd, Dd, Dd, Dd, Dd, Hd, Hd, Hd, Dd, Dd, Dd, Dd, Dd^Do, Dd, Dd, Dd, Dd, Dd, Dd, Dd, Dd, Dd, Dd, Dd, Dd, Dd, Dd, Ds, Ds, Wwt, Wwt, Wo, Wo, Wo, Wo, Wo, Wo
Wo, Wo, Wo, Wo, Wo, Wo, Wwt, Ds, Ds, Dd, Dd, Dd, Dd, Dd, Dd, Dd, Dd, Gd, Dd, Dd, Dd, Dd, Dd, Dd, Dd, Dd, Dd, Hd, Hd, Hd, Hd, Dd, Dd, Gd, Gd, Gd, Dd, Dd, Dd, Dd, Hd, Hd, Hd, Dd, Dd, Dd, Dd, Dd, Dd, Dd, Dd, Dd, Hd, Dd, Dd, Dd, Dd^Edpp, Dd, Dd, Dd, Dd, Dd, Ds, Ds, Wwt, Wo, Wo, Wo, Wo, Wo, Wo, Wo
Wo, Wo, Wo, Wo, Wwt, Wwt, Ds, Ds, Wwt, Ds, Dd, Dd^Vdt, Dd, Dd, Dd, Dd, Dd, Dd, Dd, Dd, Dd, Dd, Dd, Dd, Dd, Dd, Dd, Dd, Dd, Dd, Dd, Dd, Dd, Dd, Gd, Gd, Dd, Dd, Dd, Dd, Dd, Hd, Dd, Dd, Dd, Dd, Dd, Dd, Dd, Dd, Hd, Hd, Hd, Hd, Dd, Dd, Dd, Dd, Ds, Ds, Ds, Dd, Dd, Wwt, Wwt, Wo, Wo, Wo, Wo, Wo, Wo, Wo
Wo, Wo, Wo, Wo, Wwt, Ds, Wwt, Wwt, Wwt, Wwt, Ds, Dd, Dd, Dd, Dd, Dd, Dd^Esd, Dd, Dd, Dd, Dd, Dd, Dd, Dd, Dd, Dd, Dd, Dd, Dd, Dd, Dd, Dd, Dd, Gd, Gd, Gd, Dd, Dd, Dd, Dd, Dd, Hd, Dd, Dd, Dd, Dd, Dd, Dd, Dd, Dd, Dd, Dd, Dd, Dd, Dd, Dd, Dd, Ds, Ds, Wwt, Dd, Ds, Dd, Ds, Ds, Wwt, Wwt, Wo, Wo, Wo, Wo, Wo
Wo, Wo, Wo, Wo, Wo, Wwt, Wo, Wo, Wwt, Ds, Ds, Dd, Dd, Dd, Dd, Dd, Dd, Dd, Dd, Dd^Vda, Dd, Dd, Hd, Dd, Hd, Dd, Dd, Dd, Dd, Dd, Dd, Dd, Dd, Gd, Gd, Dd, Dd, Dd, Dd, Dd, Dd, Dd, Dd, Dd, Dd, Dd, Dd, Dd, Dd, Dd^Vdt, Dd, Dd, Yp, Dd, Dd, Dd, Dd, Ds, Ds, Wwt, Ds, Dd, Dd, Dd, Dd, Ds, Ds, Wwt, Wo, Wo, Wo, Wo
Wo, Wo, Wo, Wo, Wo, Wo, Wo, Wo, Wo, Wwt, Wwt, Ds, Ds, Ds, Ds, Ds, Dd, Dd, Dd, Dd, Dd, Dd, Hd, Hd, Dd, Hd, Dd, Dd, Dd, Dd, Dd, Dd, Gd, Gd, Gd, Gd, Dd, Dd, Dd, Dd, Dd, Dd, Dd, Dd, Dd^Esd, Dd, Dd, Dd, Dd, Dd, Dd, Yp, Yp, Yp, Ds, Dd, Dd, Dd, Dd, Wwt, Wwt, Ds, Ds, Ds, Dd, Dd^Vda, Ds, Wwt, Wo, Wo, Wo, Wo
Wo, Wo, Wo, Wo, Wo, Wo, Wo, Wo, Wwt, Wwt, Wwt, Wwt, Wwt, Wwt, Wwt, Ds, Dd, Dd, Dd, Dd, Dd, Dd, Hd, Hd, Hd, Hd, Dd, Dd, Dd, Dd, Dd, Gd, Dd, Gd^Fts, Gd^Fts, Dd, Dd, Dd, Dd, Dd, Dd, Dd, Dd, Dd, Dd, Dd, Dd, Dd, Dd, Dd, Dd, Dd, Dd, Ds, Wwt, Ds, Ds, Ds, Ds, Wwt, Wwt, Wwt, Wwt, Wwt, Ds, Dd, Ds, Wwt, Wo, Wo, Wo, Wo
Wo, Wo, Wo, Wo, Wo, Wo, Wo, Wo, Wo, Wwt, Wwt, Wo, Wo, Wo, Wwt, Ds, Dd, Dd, Dd, Dd, Dd, Dd, Dd, Hd, Dd, Dd, Dd, Dd^Vdt, Dd, Dd, Dd, Dd, Gd, Gd^Fts, Gd^Fts, Dd, Dd, Dd, Dd, Dd, Dd, Dd^Vda, Dd, Dd, Dd, Dd, Dd, Dd, Dd, Dd, 2 Kd, Cd, Cd, Ds, Wwt, Wwt, Wwt, Wwt, Ds, Wwt, Wo, Wo, Wo, Wwt, Wwt, Ds, Wwt, Wwt, Wo, Wo, Wo, Wo
Wo, Wo, Wo, Wo, Wo, Wo, Wo, Wo, Wo, Wwt, Wo, Wo, Wo, Wo, Wwt, Ds, Dd, Dd, Dd, Dd, Dd, Dd, Dd, Dd, Dd, Dd, Dd, Dd, Dd^Edpp, Dd, Dd, Dd, Gd^Fts, Gd^Fts, Dd, Dd, Dd, Dd, Dd, Dd, Dd, Dd, Dd, Dd, Ds, Ds, Ds, Ds, Ds, Cd, Cd, Cd, Wwt, Wwt^Bw\, Wwt, Wo, Wwt, Ds, Wo, Wwt, Wo, Wo, Wo, Wo, Wo, Wwt, Wo, Wo, Wo, Wo, Wo, Wo
Wo, Wo, Wo, Wo, Wo, Wo, Wo, Wo, Wo, Wo, Wo, Wo, Wo, Wo, Wwt, Ds, Ds, Cd, Dd, Dd, Dd^Vda, Dd, Dd, Dd, Dd, Dd^Esd, Dd, Dd, Dd, Dd, Dd, Dd, Dd, Dd, Dd, Dd, Dd, Dd, Dd^Esd, Dd, Dd, Dd, Ds, Ds, Wwt, Wwt, Wo, Wwt, Wwt, Cd, Wwt^Bw\, Wwt, Wwt, Wo, Wo, Wo, Wo, Wwt, Wo, Wwt, Wo, Wo, Wo, Wo, Wo, Wo, Wo, Wo, Wo, Wo, Wo, Wo
Wo, Wo, Wo, Wo, Wo, Wo, Wo, Wo, Wo, Wo, Wo, Wo, Wo, Wo, Wwt, Wwt, Wwt, Ds, Ds, Dd, Ds, Ds, Ds, Ds, Ds, Dd, Dd, Dd, Dd, Dd, Dd, Dd, Ds, Ds, Ds, Dd, Dd, Dd, Dd, Dd, Dd, Dd, Ds, Wwt, Wwt, Wwt, Wo, Wo, Wo, Wwt, Wo, Wwt, Wo, Wo, Wo, Wo, Wo, Wo, Wo, Wo, Wo, Wo, Wo, Wo, Wo, Wo, Wo, Wo, Wo, Wo, Wo, Wo
Wo, Wo, Wo, Wo, Wo, Wo, Wo, Wo, Wo, Wo, Wo, Wo, Wo, Wo, Wo, Wo, Wwt, Wwt, Ds, Dd, Ds, Wwt, Wwt, Wwt, Wwt, Ds, Ds, Dd, Ds, Ds, Ds, Ds, Wwt, Ds, Dd, Dd^Vda, Dd, Dd, Ds, Ds, Ds, Ds, Wwt, Wwt, Wwt, Wwt, Wo, Wo, Wo, Wo, Wo, Wo, Wo, Wo, Wo, Wo, Wo, Wo, Wo, Wo, Wo, Wo, Wo, Wo, Wo, Wo, Wo, Wo, Wo, Wo, Wo, Wo
Wo, Wo, Wo, Wo, Wo, Wo, Wo, Wo, Wo, Wo, Wo, Wo, Wo, Wo, Wo, Wo, Wwt, Wwt, Ds, Ds, Wwt, Wwt, Wo, Wo, Wo, Wwt, Wwt, Ds, Wwt, Wwt, Wwt, Wwt, Ds, Ds, Dd, Dd, Dd, Dd, Ds, Wwt, Wwt, Wwt, Wwt, Wwt, Wwt, Wwt, Wo, Wo, Wo, Wo, Wo, Wo, Wo, Wo, Wo, Wo, Wo, Wo, Wo, Wo, Wo, Wo, Wo, Wo, Wo, Wo, Wo, Wo, Wo, Wo, Wo, Wo
Wo, Wo, Wo, Wo, Wo, Wo, Wo, Wo, Wo, Wo, Wo, Wo, Wo, Wo, Wo, Wo, Wwt, Wwt, Wwt, Wwt, Wwt, Wo, Wo, Wo, Wo, Wwt, Wwt, Wwt, Wo, Wo, Wo, Wo, Wwt, Ds, Dd, Dd, Dd, Dd, Ds, Wwt, Wwt, Wo, Wo, Wwt, Wwt, Ww^Vm, Wo, Wo, Wo, Wo, Wo, Wo, Wo, Wo, Wo, Wo, Wo, Wo, Wo, Wo, Wo, Wo, Wo, Wo, Wo, Wo, Wo, Wo, Wo, Wo, Wo, Wo
Wo, Wo, Wo, Wo, Wo, Wo, Wo, Wo, Wo, Wo, Wo, Wo, Wo, Wo, Wo, Wo, Wo, Wwt, Wwt, Wo, Wo, Wo, Wo, Wo, Wo, Wwt, Wwt, Wo, Wo, Wo, Wo, Wo, Wwt, Wwt, Ds, Dd^Dc, Ds, Ds, Wwt, Wwt, Wo, Wo, Wo, Wo, Wo, Wo, Wo, Wo, Wo, Wo, Wo, Wo, Wo, Wo, Wo, Wo, Wo, Wo, Wo, Wo, Wo, Wo, Wo, Wo, Wo, Wo^Vm, Wo, Wo, Wo, Wo, Wo, Wo
Wo, Wo, Wo, Wo, Wo, Wo^Vm, Wo, Wo, Wo, Wo, Wo, Wo, Wo, Wo, Wo, Wo, Wo, Wo, Wo, Wo, Wo, Wo, Wo, Wo, Wo, Wo, Wo, Wo, Wo, Wo, Wo, Wo, Wwt, Ds, Wwt, Ds, Ds, Ds, Wwt, Wwt, Wo, Wo, Wo, Wo, Wo, Wo, Wo, Wo, Wo, Wo, Wo, Wo, Wo, Wo, Wo, Wo, Wo, Wo, Wo, Wo, Wo, Wo, Wo, Wo, Wo, Wo, Wo, Wo, Wo, Wo, Wo, Wo
Wo, Wo, Wo, Wo, Wo, Wo, Wo, Wo, Wo, Wo, Wo, Wo, Wo, Wo, Wo, Wo, Wo, Wo, Wo, Wo, Wo, Wo, Wo, Wo, Wo, Wo, Wo, Wo, Wo, Wo, Wo, Wo, Wo, Wwt, Wwt, Ds, Wwt, Wwt, Wo, Wo, Wo, Wo, Wo, Wo, Wo, Wo, Wo, Wo, Wo, Wo, Wo, Wo, Wo, Wo, Wo, Wo, Wo, Wo, Wo, Wo, Wo, Wo, Wo, Wo, Wo, Wo, Wo, Wo, Wo, Wo, Wo, Wo
Wo, Wo, Wo, Wo, Wo, Wo, Wo, Wo, Wo, Wo, Wo, Wo, Wo, Wo, Wo, Wo, Wo, Wo, Wo, Wo, Wo, Wo, Wo, Wo, Wo, Wo, Wo, Wo, Wo, Wo, Wo, Wo, Wo, Wo, Wo, Wwt, Wo, Wo, Wo, Wo, Wo, Wo, Wo, Wo, Wo, Wo, Wo, Wo, Wo, Wo, Wo, Wo, Wo, Wo, Wo, Wo, Wo, Wo, Wo, Wo, Wo, Wo, Wo, Wo, Wo, Wo, Wo, Wo, Wo, Wo, Wo, Wo
Wo, Wo, Wo, Wo, Wo, Wo, Wo, Wo, Wo, Wo, Wo, Wo, Wo, Wo, Wo, Wo, Wo, Wo, Wo, Wo, Wo, Wo, Wo, Wo, Wo, Wo, Wo, Wo, Wo, Wo, Wo, Wo, Wo, Wo, Wo, Wo, Wo, Wo, Wo, Wo, Wo, Wo, Wo, Wo, Wo, Wo, Wo, Wo, Wo, Wo, Wo, Wo, Wo, Wo, Wo, Wo, Wo, Wo, Wo, Wo, Wo, Wo, Wo, Wo, Wo, Wo, Wo, Wo, Wo, Wo, Wo, Wo
