Ss, Ss, Ss, Ss, Ss, Ss, Ss, Ww, Ss, Ss, Ss, Ss, Ss, Ss, Ss, Ss, Ss, Ss, Ss, Ss, Ss, Ss, Ss, Ss, Ss, Rd, Ss, Ss, Ss, Ss, Ss, Ss, Ss, Ss, Ss, Ss, Hh, Ss, Hh, Ss, Ss, Ss, Ss, Ss, Ss, Ss, Hh, Gg, Gg, Mm, Gg, Gg
Ss, Ss, Ss, Ss, Ss, Ss, Ss, Ww, Ss, Ss, Ss, Ss, Ss, Ss, Ss, Ss, Ss, Ss, Ss, Ss, Xoa, Ss, Ss, Ss, Ss, Rd, Ss, Ss, Ss, Ss, Xoa, Ss, Ss, Ss, Ss, Ss, Hh, Ss, Hh, Ss, Ss, Ss, Ss, Ss, Ss, Ss, Hh, Gg, Gg, Mm, Gg, Gg
Ss, Ss, Ss, Ss, Ss, Ss, Ww, Ww, Hh, Ss, Ss, Hh, Hh, Ss, Hh, Hh, Gg^Efm, Gg, Xoa, Xoa, Gg, Ss, Gg^Efm, Ss, Re, Rd, Re, Ss, Gg, Ss, Gg, Xoa, Xoa, Ss, Hh, Hh, Ss, Ss, Hh, Hh, Ss, Ss, Hh, Hh, Mm, Hh, Mm, Hh, Hh, Gg, Gg, Gg
Ss, Ss, Ss, Ss, Ww, Ww, Ss, Hh, Mm, Hh, Hh, Hh, Hh, Hh, Gg, Gg, Gg, Xoa, Gg^Efm, Gg^Efm, Re, Gg, Re, Re, Re, Rd, Re, Re, Re, Gg, Re, Ss, Gg^Efm, Xoa, Gg, Hh, Hh, Gg, Ss, Ss, Hh, Hh, Mm, Mm, Gg^Efm, Mm, Gg, Gg, Gg, Hh, Hh, Hh
Ss, Ss, Ss, Ss, Ww, Hh, Mm, Mm, Mm, Gg^Efm, Gg, Gg, Gg^Efm, Gg^Efm, Gg, Gg, Re, Re, Re, Re, Xoa, Re, Xoa, Re, Xoa, Ch, Xoa, Re, Xoa, Re, Xoa, Re, Re, Re, Hh, Gg, Gg, Hh, Gg^Efm, Hh, Hh, Gg, Hh, Gg, Hh, Gg, Hh, Gg^Efm, Hh, Hh, Hh, Hh
Ss, Ss, Ss, Ww, Hh, Hh, Mm, Mm, Hh, Hh, Gg, Hh, Gg, Gg^Efm, Re, Re, Xoa, Xoa, Xoa, Xoa, Rr, Xoa, Rr, Xoa, Rr, Rp, Rr, Xoa, Rr, Xoa, Rr, Xoa, Xoa, Xoa, Xoa, Re, Re, Gg^Efm, Gg^Efm, Hh, Gg^Efm, Gg, Gg, Hh, Hh, Hh, Hh, Gg^Efm, Gg, Gg, Gg, Gg
Ss, Ss, Ss, Ww, Hh, Hh, Mm, Mm^Vhh, Ss, Gg, Gg^Efm, Gg, Re, Re, Xoa, Xoa, Rp, Rr^Dr, Rr, Rr, Rr, Rr, Rr^Vd, Rr, Ch, Rp, Ch, Rr, Rr^Vhc, Rr, Rr, Rr, Rr, Rr^Dr, Rp, Xoa, Re^Dr, Re, Re, Gg^Efm, Gg, Hh, Hh, Hh, Gg, Hh, Hh, Hh, Gg, Hh, Hh, Hh
Ss, Ss, Ss, Ww, Ss, Hh, Mm, Ss, Ss, Ss, Gg^Efm, Re, Xoa, Xoa, Rr, Rr, Rr, Rr, Xoa, Rr, Xoa, Xoa, Wo, Xoa, Rr, Rp, Rr^Dr, Xoa, Wo, Xoa, Xoa, Rr, Xoa, Rr, Rr, Rr, Rr, Xoa, Xoa, Mm, Gg, Gg, Mm, Mm, Mm, Hh, Hh, Mm, Hh, Hh, Hh, Hh
Ss, Ss, Ss, Ww, Ss, Hh, Mm, Ss, Hh, Hh, Gg, Re, Xoa, Rr, Rr^Vd, Rr, Xoa, Xoa, Qlf, Xoa, Wo, Wo, Ch, Wo, Rr, Rp, Rr, Wo, Ch, Wo, Wo, Xoa, Qlf, Xoa, Xoa, Rr, Rr^Vd, Rr, Xoa, Re, Hh, Hh, Mm, Mm, Mm, Gg, Hh, Gg^Efm, Gg, Hh, Gg, Gg
Ss, Ss, Ss, Ww, Hh, Hh, Gg, Hh, Hh, Gg, Gg, Re, Xoa, Rr, Xoa, Xoa, Qlf, Qlf, Qlf, Xoa, Wo, Ch, 6 Kh, Ch, Rr, Rp, Rr, Ch, 7 Kh, Ch, Wo, Xoa, Qlf, Qlf, Qlf, Xoa, Xoa, Rr, Xoa, Hh, Hh, Gg, Gg^Efm, Hh, Gg, Hh, Gg^Efm, Gg^Efm, Hh, Hh, Hh, Hh
Ss, Ss, Gg, Ww, Hh, Hh, Hh, Hh, Gg, Gg, Hh, Re, Xoa, Rp^Dr, Xoa, Xoa, Xoa, Xoa, Xoa, Xoa, Wo, Ch, Ch, Ch, Rr, Rp, Rr, Ch, Ch, Ch, Wo, Xoa, Xoa, Xoa, Xoa, Xoa, Xoa, Rp, Xoa, Hh, Hh, Gg^Efm, Gg^Efm, Gg^Efm, Hh, Hh, Gg, Hh, Gg, Gg, Gg, Gg
Gg, Gg, Gg, Ww, Ww, Hh, Hh, Gg, Gg, Hh, Gg, Re, Xoa, Rp, Rr, Rr, Rp, Rr^Dr, Rr, Rr, Rr, Rr, Rr, Rr, Rr, Rp, Rr, Rr, Rr, Rr, Rr, Rr, Rr, Rr, Rp^Dr, Rr, Rr, Rp, Xoa, Hh, Hh, Gg, Hh, Hh, Hh, Hh, Gg, Gg, Gg^Efm, Gg, Gg, Gg^Efm
Ss, Gg, Gg^Efm, Gg, Ss, Ww, Ww, Gg^Efm, Gg^Efm, Hh, Gg^Efm, Re, Xoa, Rp, Rr^Vhc, Rr, Wo, Rr, Rr, Rr, Wo, Rr, Rr^Vd, Rr, Rr, Rp, Rr, Rr, Rr^Vd, Rr, Wo, Rr^Dr, Rr, Rr, Wo, Rr, Rr^Vd, Rp, Xoa, Hh, Hh, Hh, Mm, Hh, Hh, Hh, Hh, Gg, Gg, Gg^Efm, Gg, Gg^Efm
Ss, Gg, Gg, Gg^Efm, Gg, Ss, Ww, Gg, Gg^Efm, Gg, Gg, Re, Xoa, Rr, Wo, Wo, Xoa, Wo, Wo, Wo, Xoa, Wo, Wo, Wo, Rr^Dr, Rp, Rr, Wo, Wo, Wo, Xoa, Wo, Wo, Wo, Xoa, Wo, Wo, Rr, Xoa, Hh, Hh, Mm, Mm, Mm, Hh, Hh, Hh, Hh, Gg, Gg, Gg^Efm, Gg^Efm
Ss, Ss, Gg, Gg, Ss, Ss, Ww, Ww, Ww, Ss, Ww, Re, Xoa, Rr, Wo, Xoa, Ww, Xoa, Ww, Xoa, Ww, Xoa, Xoa, Wo, Rr, Rp, Rr^Dr, Wo, Xoa, Xoa, Ww, Xoa, Ww, Xoa, Ww, Xoa, Wo, Rr, Xoa, Hh, Hh, Mm, Mm, Mm, Hh, Hh, Hh, Hh, Hh, Gg^Efm, Gg, Gg
Ss, Ss, Xoa, Gg, Ss, Ww, Xoa, Xoa, Xoa, Ww, Xoa, Xoa, Rr^Dr, Rr, Wo, Xoa, Xoa, Ww, Xoa, Ww, Xoa, Ww, Xoa, Wo, Rr, Rp, Rr, Wo, Xoa, Ww, Xoa, Ww, Xoa, Ww, Xoa, Xoa, Wo, Rr, Rr^Dr, Xoa, Xoa, Mm, Xoa, Xoa, Xoa, Hh, Hh, Xoa, Hh, Gg^Efm, Gg^Efm, Gg
Ss, Ss, Xoa, Gg, Re, Xoa, Rr^Dr, Rr^Dr, Rr^Vhc, Xoa, Rr, Rr, Rr, Rp, Wo, Wo, Wo, Xoa, Wo, Wo, Wo, Xoa, Wo, Wo, Rr, Rp, Rr, Wo, Wo, Xoa, Wo, Wo, Wo, Xoa, Wo, Wo, Wo, Rp, Rr, Rr, Rr, Xoa, Rr^Dr, Rr, Rr, Xoa, Hh, Xoa, Hh, Gg, Gg^Efm, Gg
Ss, Ss, Xoa, Gg^Efm, Re, Xoa, Ch, 3 Kh, Ch, Ch, Rr, Xoa, Rr, Rp, Rr, Rr^Vhc, Rr, Wo, Rr, Rr, Rr, Wo, Rr, Rr^Dr, Rr, Rr, Rr, Rr^Vd, Rr, Wo, Rr, Rr, Rr, Wo, Rr, Rr^Vd, Rr, Rp, Rr, Xoa, Rr, Ch, Ch, 4 Kh, Ch, Xoa, Re, Xoa, Gg, Gg^Efm, Ww, Ww
Gg, Gg^Efm, Xoa, Gg, Re, Xoa, Xoa, Ch, Ch, Rr, Rr^Dr, Xoa, Rr, Rp, Rr, Xoa, Rr, Rp, Rr^Dr, Xoa, Rr, Rp, Rr, Rr, Ch, Ch, Ch, Rr, Rr, Rp, Rr, Xoa, Rr, Rp, Rr, Xoa, Rr, Rp^Dr, Rr, Xoa, Rr, Rr, Ch, Ch, Xoa, Xoa, Re, Xoa, Ww, Ww, Re, Re
Ss, Gg, Ss, Gg, Ss, Re, Re, Xoa, Xoa, Rr, Rr, Xoa, Rr, Rp, Rr, Xoa, Rr, Rp, Rr, Xoa, Rr, Rp, Rr, Rr, Ch, 5 Kh, Ch, Rr, Rr, Rp, Rr, Xoa, Rr^Dr, Rp, Rr, Xoa, Rr, Rp, Rr^Dr, Xoa, Rr, Rr, Xoa, Xoa, Re, Re, Gs, Ww, Re, Re, Re, Re
Ss, Ss, Ss, Ss, Ss, Re, Re, Re, Hh, Xoa, Xoa, Rr, Rr, Rp, Xoa, Rr^Vd, Wo, Wo, Wo, Rr, Xoa, Xoa, Wo, Rr^Vd, Rr, Ch, Rr, Rr^Vhc, Wo, Xoa, Xoa, Rr, Wo, Wo, Wo, Rr^Vd, Xoa, Rp, Rr, Rr, Xoa, Xoa, Re, Re, Gs, Gs, Ww^Bsb\, Ww, Re, Re, Re, Re
Ss, Gs, Gs, Gg, Gs, Gs, Hh, Hh, Hh, Re, Re, Xoa, Xoa, Rr, Xoa, Wo, Wo, Wo, Xoa, Wo, Wo, Wo, Wo, Wo, Rr, Rr, Rr, Wo, Wo, Wo, Wo, Wo, Xoa, Wo, Wo, Wo, Xoa, Rr, Xoa, Xoa, Re, Re, Gs, Gg, Ww, Ww, Re, Rd, Rd, Re, Re, Re
Gs, Gs, Gg, Gg, Gs, Hh, Hh, Hh, Hh, Hh, Re, Re, Xoa, Rr, Wo, Wo, Xoa, Xoa, Ql, Xoa, Xoa, Wo, Wo, Xoa, Rr^Dr, Rp, Rr, Xoa, Wo, Wo, Xoa, Xoa, Ql, Xoa, Xoa, Wo, Wo, Rr^Dr, Xoa, Re, Re, Hh, Hh, Gs, Ww, Re, Re, Re^Vct, Re, Rd, Rd, Rd
Ss, Gs, Gg, Gg, Gs, Hh, Hh, Hh, Hh, Hh, Gs, Re, Xoa, Rr, Wo, Xoa, Xoa, Ql, Ql, Ql, Xoa, Xoa, Wo, Xoa, Rr, Rp, Rr, Xoa, Wo, Xoa, Xoa, Ql, Ql, Ql, Xoa, Xoa, Wo, Rr, Xoa, Re, Hh, Hh, Gg, Gs, Ww, Re, Re, Re, Re, Re, Re, Re
Ss, Gs, Gs, Gs, Hh, Hh, Hh, Hh, Hh, Hh, Hh, Re, Xoa, Rr^Dr, Wo, Wo, Wo, Xoa, Xoa, Xoa, Wo, Wo, Wo, Wo, Rr, Rp, Rr, Wo, Wo, Wo, Wo, Xoa, Xoa, Xoa, Wo, Wo, Wo, Rr, Xoa, Re, Gs, Gg, Ww, Ww, Re, Re, Re, Re, Re, Re, Re, Re
Ss, Gs, Gs, Hh, Gg, Gs, Gg, Hh, Gs, Hh, Gs, Re, Xoa, Rr, Wo, Wo, Wo, Wo, Wo, Wo, Rr, Wo, Rr, Rr^Vd, Rr, Rp, Rr, Rr^Vd, Rr, Wo, Rr, Wo, Wo, Wo, Wo, Wo, Wo, Rr, Xoa, Re, Gs, Ww, Gs^Ft, Re, Gs^Ft, Gs^Ft, Re, Re, Re, Re, Re, Re
Gg, Gg, Gs, Gs, Hh, Gg, Gg, Hh, Hh, Hh, Gs, Re, Xoa, Rr, Rr, Wo, Rr^Vhc, Wo, Rr, Rr, Rp^Dr, Rr, Xoa, Rr, Ch, Rp, Rr^Dr, Rr, Xoa, Rr, Rp^Dr, Rr, Rr, Wo, Rr^Vd, Wo, Rr, Rr^Dr, Xoa, Re, Gg, Ww, Re, Gs^Ft, Gs^Ft, Gs^Ft, Gs^Ft, Gs^Ft, Re, Re, Re, Re
Ww, Gg, Gg, Hh, Hh, Hh, Gs, Gs, Gs, Gs, Gs, Re, Re, Xoa, Xoa, Rr, Rp, Rr, Xoa, Xoa, Xoa, Xoa, Xoa, Xoa, Rr^Dr, Rp, Rr, Xoa, Xoa, Xoa, Xoa, Xoa, Xoa, Rr, Rp, Rr, Xoa, Xoa, Re, Re, Gg, Ww, Re, Re, Re, Gs^Ft, Gs^Ft, Re, Re, Re, Re, Re
Gs, Ww, Ww, Gg, Hh, Hh, Gs, Gs, Gg, Gs^Ft, Gs, Gs, Gs, Re, Re, Xoa, Rp, Xoa, Re, Re, Re, Re, Re, Xoa, Rr, Rr, Rr, Xoa, Re, Re, Re, Re, Re, Xoa, Rp, Xoa, Re, Re, Gs, Gs, Ww, Ww, Ww, Gs^Ft, Gs^Ft, Re, Re, Gs^Ft, Re, Re, Re, Re
Gg, Gs, Gs^Ft, Ww, Ww, Gs, Gs, Gs^Vht, Gg, Gs, Hh, Gs, Hh, Gs, Re, Xoa, Ch, Xoa, Re, Gg, Gs, Gs, Re, Xoa, Xoa, Ch, Xoa, Xoa, Re, Gs, Gg, Gs, Re, Xoa, Ch, Xoa, Re, Gg, Ww, Ww, Re, Gs^Ft, Ww, Gs^Ft, Re, Re, Re, Re, Re^Vct, Re, Re, Re
Gg, Gg, Gs^Ft, Gs^Ft, Gs, Ww, Ww, Gg, Gs, Hh, Hh, Hh, Gg, Gs, Gs, Re, Re, Rd, Rd, Gg, Gs^Ft, Gs, Xoa, Re, Re, Rd, Re, Re, Xoa, Gs, Gs, Gg, Rd, Rd, Re, Re, Gs, Gs, Ww, Re, Gs^Ft, Gs^Ft, Re^Vct, Ww, Gs^Ft, Re, Gs^Ft, Re, Gs^Ft, Re, Re, Re
Gs^Ft, Gs^Ft, Gs^Ft, Gs, Gs, Gg, Gg, Ww, Ww, Gs, Gs, Gg, Gg, Gg, Gs, Gs, Gs^Ft, Gs, Xoa, Rd, Rd, Gs^Ft, Gg, Xoa, Gg, Rd, Gs, Xoa, Gs, Gs, Rd, Rd, Xoa, Gs, Gs, Gg, Gg, Ww, Re, Gs^Ft, Re, Re, Re, Ww, Re, Re, Re, Gs^Ft, Re, Re, Re, Re
Gs, Gs, Gg, Gs, Gs^Vht, Gg, Gg, Gs, Gg, Ww, Ww, Gs, Gs^Ft, Gs, Gs^Ft, Gs^Ft, Gs^Ft, Gs^Ft, Gs^Ft, Xoa, Xoa, Rd, Rd, Gg, Gg, Rd, Gs, Gg, Rd, Rd, Xoa, Xoa, Gs, Gs, Gg, Gs, Gs^Ft, Ww, Re, Re, Gs^Ft, Gs^Ft, Gs^Ft, Ww, Ww, Re, Gs^Ft, Re, Re, Re, Re, Re
Gs, Gg, Gs, Gs, Gs, Gs, Gs^Ft, Gs, Gg, Gg, Ww, Gs^Ft, Gs, Gs, Gs, Gs, Gs, Gs, Gs, Gs, Gs, Xoa, Xoa, Rd, Rd, Rd, Rd, Rd, Xoa, Xoa, Gs, Gs, Gs^Ft, Gg, Gs, Gs, Ww, Ww, Re^Vct, Re, Re, Re, Gs^Ft, Re, Re, Ww, Re, Re^Vct, Re, Re, Gs^Ft, Gs^Ft
Hh, Hh, Hh, Hh, Gg, Gg, Gs, Gs, Gs, Gg, Gs, Ww, Ww, Gs^Ft, Gs^Ft, Gs, Gs^Ft, Gs, Gs^Ft, Gs^Ft, Gs^Ft, Gs, Gs, Gs, Rd, Rd, Rd, Gs, Gg, Gg, Gs, Gs^Ft, Gs^Ft, Gs^Ft, Ww, Ww, Gs^Ft, Gs^Ft, Re, Re, Re, Re, Re, Re, Ww, Ww, Ww, Re, Re, Re, Re, Re
Hh, Hh, Gs, Gs, Gs, Gs, Gs^Ft, Gg, Gs^Ft, Gs, Gs^Ft, Gs^Ft, Ww, Gs^Ft, Gs^Ft, Gs^Ft, Gs^Ft, Gs^Ft, Gs^Ft, Gs, Gg, Gs, Gg, Gs, Rd, Gs, Gs, Rd, Rd, Gs, Gs^Ft, Gs^Ft, Gs^Ft, Gs, Ww, Re, Re, Gs^Ft, Re, Re, Re, Gs^Ft, Re, Re, Ww, Re, Re, Ww, Ww, Re, Re, Re
Hh, Gs, Gg, Gg, Gs^Ft, Gs^Ft, Gs^Ft, Gs^Ft, Gs^Ft, Gs^Ft, Gs^Ft, Gs^Ft, Ww, Gs^Ft, Gs^Ft, Gs^Ft, Gs^Ft, Gs^Ft, Gs^Ft, Gs^Ft, Gs, Gg, Gs, Gg, Rd, Gg, Gg, Gs, Gs, Rd, Rd, Gs^Ft, Gg, Gs, Ww, Re, Re, Gs^Ft, Re, Gs^Ft, Re^Vct, Re, Re, Re, Ww, Re, Re^Vct, Re, Re, Ww, Re, Gs^Ft
Gs, Gs, Gg, Gs, Gs^Ft, Gs^Ft, Gs^Ft, Gs^Ft, Gs^Ft, Gs^Ft, Gs^Ft, Gs^Ft, Ww, Gs^Ft, Gs^Ft, Gs^Ft, Gg, Gs^Ft, Gs, Gs^Vht, Gs, Gg, Gs, Gs, Rd, Gs, Gg, Gg, Gs, Gs, Gg, Rd, Rd, Gs, Ww, Re, Re, Re, Re, Re, Gs^Ft, Re, Re, Ww, Re, Re, Re, Re, Gs^Ft, Ww, Ww, Gs^Ft
Gs, Gs, Gs^Ft, Gs, Gs^Ft, Gs^Ft, Gs^Ft, Gs^Ft, Gs^Ft, Gs^Ft, Gs^Ft, Gs^Ft, Ww, Gs^Ft, Gs^Ft, Gs^Ft, Gs^Ft, Gg, Gs, Gs, Hh, Hh, Gg, Gs, Rd, Gs, Gg, Gg, Gs, Gs, Gs^Ft, Gg, Gs, Rd, Ww^Bsb\, Re, Re, Re, Re, Re, Re, Re, Re, Ww, Re, Re, Re, Gs^Ft, Gs^Ft, Gs^Ft, Gs^Ft, Ww
Gs, Gg, Gs, Gs^Ft, Gs^Ft, Gs^Vht, Gs^Ft, Gs^Ft, Gs^Ft, Gs^Ft, Gs^Ft, Gs^Ft, Gs^Ft, Ww, Gs^Ft, Gs^Ft, Gs, Gs, Hh, Hh, Hh, Gs, Gs, Gg, Rd, Gs, Gs, Gs, Gs^Ft, Gs, Gs^Ft, Gs^Ft, Gs, Gs, Ww, Rd, Rd, Re, Re, Re, Re, Re, Ww, Ww, Gs^Ft, Re, Re, Re, Re, Gs^Ft, Gs^Ft, Gs^Ft
Gs, Gg, Gg, Gs, Gs, Gs, Gs^Ft, Gs^Ft, Gs^Ft, Gs^Ft, Gs^Ft, Gs^Ft, Gs^Ft, Ww, Gs^Vht, Gs^Ft, Gs, Gg, Gg, Hh, Hh, Hh, Gs, Gs, Ce, Gs, Gs, Gs^Ft, Gs^Ft, Gs, Gs^Ft, Gs^Ft, Gs^Ft, Gg, Ww, Re, Re, Rd, Rd, Re, Re, Ww, Gs^Ft, Gs^Ft, Gs^Ft, Gs^Ft, Re, Re, Re, Re, Re, Gs^Ft
Gs^Ft, Gs^Ft, Gs, Gs, Gs^Ft, Gs^Ft, Gs^Ft, Gs^Ft, Gs^Ft, Gs^Ft, Gs^Ft, Gs^Ft, Gs^Ft, Ww, Gs^Ft, Gs^Ft, Gs^Ft, Gg, Gs, Hh, Hh, Gs, Gg, Ce, 2 Ke, Ce, Gs, Gs, Gs^Ft, Gs, Gg, Gs, Gs^Vht, Gg, Ww, Re, Re, Re, Re, Rd, Ww^Bsb\, Ww, Ce, Re, Re, Re, Re, Re, Gs^Ft, Re, Re, Re
Gs, Gs, Gg, Gs, Gs, Gs^Ft, Gs^Ft, Gs^Ft, Gs, Gs, Gs^Ft, Gs^Ft, Gs^Ft, Ww, Gs^Ft, Gs^Ft, Gs^Ft, Gs, Hh, Hh, Hh, Gg, Gs, Ce, Ce, Ce, Gg, Gs, Gs^Ft, Gg, Gs, Gg, Gs, Gs, Ww, Re, Re, Re, Re, Ww, Re, Ce, 1 Ke, Ce, Re, Re, Re, Re, Re, Re, Re, Re
Gs, Gg, Gs, Gs, Gs, Gg, Gg, Gs^Ft, Gs^Ft, Gs^Vht, Gs^Ft, Gs^Ft, Gs^Ft, Ww, Ww, Gg, Gg, Gs^Vht, Gs, Hh, Hh, Hh, Gs, Gs, Rd, Gs, Gg, Gg, Gs, Gs^Ft, Gs^Ft, Gs^Ft, Ww, Ww, Gs^Ft, Re, Re, Gs^Ft, Ww, Ww, Re, Ce, Ce, Ce, Re, Re, Re, Re, Gs^Ft, Re, Gs^Ft, Re
Gg, Gg, Gs, Gs^Ft, Gs^Ft, Gg, Gs, Gs, Gs^Ft, Gs^Ft, Gs^Ft, Gs, Gs, Gs^Ft, Gs, Ww, Ww, Gg, Gg, Gs, Gs, Hh, Hh, Gs, Rd, Gs, Gs^Vht, Gg, Gg, Gs, Ww, Ww, Re, Re, Re, Re, Re, Gs^Ft, Ww, Gs^Ft, Gs^Ft, Re, Rd, Re, Re, Re, Re, Gs^Ft, Gs^Ft, Gs^Ft, Gs^Ft, Gs^Ft
Gs, Gs, Gs, Gg, Gg, Gs^Ft, Gs, Gs, Gs^Ft, Gs^Ft, Gs^Ft, Gg, Gs^Ft, Gs^Ft, Gs^Ft, Gs, Gg, Ww, Ww, Gg, Gs, Hh, Gs, Gs, Rd, Gs, Gs, Gs, Gg, Gs, Ww, Re, Re, Re, Re, Re, Re, Ww, Re, Gs^Ft, Re, Re, Rd, Re, Re, Re, Re, Re, Re^Vct, Gs^Ft, Gs^Ft, Gs^Ft
Gs^Ft, Gs^Ft, Gs^Ft, Gg, Gs, Gs, Gs, Gs, Gg, Gs^Ft, Gs, Gs, Gg, Gs, Gs^Ft, Gs, Gg, Gg, Gs, Ww, Ww, Gs, Gg, Gg, Rd, Gg, Gg, Gs, Ww, Ww, Re, Gs^Ft, Gs^Ft, Gs^Ft, Gs^Ft, Re, Ww, Ww, Ww, Re, Re, Re, Rd, Re, Re, Re, Re, Re, Re, Re, Gs^Ft, Gs^Ft
Gs^Ft, Gs^Ft, Gs^Ft, Gs^Ft, Gs^Ft, Gg, Gg, Hh, Gs, Gs, Hh, Gs, Gs, Gg, Gs, Gs, Gs, Gs, Gs^Ft, Gs^Ft, Gs^Ft, Ww, Ww, Gs, Rd, Gg, Ww, Ww, Re, Re, Re, Gs^Ft, Gs^Ft, Gs^Ft, Gs^Ft, Gs^Ft, Ww, Re, Re, Ww, Ww, Ww, Ww^Bw|, Re, Re, Re, Re, Re, Ww, Ww, Ww, Gs^Ft
Gs^Ft, Gs^Ft, Gs^Ft, Gs^Ft, Gs, Gg, Gs, Hh, Hh, Hh, Gs, Hh, Hh, Gs, Hh, Hh, Gs, Gs^Ft, Gs, Gs^Ft, Gs^Ft, Gg, Gg, Ww, Ww^Bsb|, Ww, Gs^Ft, Re, Re, Re, Gs^Ft, Re, Gs^Ft, Gs^Ft, Gs^Ft, Gs^Ft, Ww, Gs^Ft, Gs^Ft, Re, Gs^Ft, Re, Rd, Ww, Ww, Ww, Ww, Ww, Gs^Ft, Re, Re, Ww
Gs^Ft, Gs^Ft, Gs, Gs, Gs^Ft, Gs^Ft, Gs^Ft, Gs, Gg, Hh, Hh, Hh, Hh, Hh, Gg, Gg, Gs^Ft, Gs^Ft, Gs, Gs^Ft, Gs, Gs, Ww, Ww, Rd, Re, Re, Re, Re, Gs^Ft, Gs^Ft, Gs^Ft, Re, Re, Gs^Ft, Ww, Re, Gs^Ft, Gs^Ft, Re, Re, Re, Rd, Gs^Ft, Re, Re, Re, Re, Re, Re, Re, Re
Gs^Ft, Gs^Ft, Gg, Gs, Gs^Ft, Gs^Ft, Gs^Ft, Gs, Gg, Gg, Gs, Gs, Gs, Gg, Gg, Gg, Gg, Gs^Ft, Gs^Ft, Gs, Ww, Ww, Re, Gs^Ft, Rd, Re, Re, Re, Re, Gs^Ft, Re, Re, Gs^Ft, Gs^Ft, Ww, Ww, Re, Re, Gs^Ft, Re, Re, Re, Rd, Gs^Ft, Gs^Ft, Re, Re, Re, Re, Re, Gs^Ft, Re
Gs^Ft, Gs^Ft, Gs^Ft, Gs^Ft, Gs^Ft, Gs^Ft, Gs^Ft, Gs^Ft, Gs^Ft, Gg, Gs, Gs, Gs^Ft, Gs^Ft, Gs^Ft, Gs^Ft, Gs^Ft, Gs^Ft, Gs^Ft, Gs, Ww, Re, Gs^Ft, Gs^Ft, Rd, Gs^Ft, Gs^Ft, Gs^Ft, Gs^Ft, Gs^Ft, Re, Re, Re, Re, Ww, Re, Gs^Ft, Gs^Ft, Gs^Ft, Gs^Ft, Re, Re, Rd, Gs^Ft, Gs^Ft, Re, Gs^Ft, Gs^Ft, Gs^Ft, Gs^Ft, Gs^Ft, Gs^Ft
