Aa^Fma, Aa^Fma, Aa^Fma, Aa^Fma, Aa^Fma, Aa^Fma, Aa^Fma, Aa, Aa, Aa^Fma, Aa^Fma, Aa^Fma, Aa^Fma, Aa^Fma, Gll^Fmw, Aa^Fma, Aa, Aa^Fma, Aa^Fma, Aa^Fpa, Aa^Fma, Aa^Fma, Aa^Fma, Aa^Fma, Aa^Fma, Ww, Ww, Ww, Ww, Aa, Gll^Fmw, Aa, Aa, Gll^Fmw, Gll^Fmw, Gll^Fmw, Gll^Fmw, Aa, Aa^Fma, Aa^Fma, Aa^Fma, Aa, Aa, Aa^Fma, Aa, Aa, Gll^Fmw, Aa, Gd, Aa^Fpa, Gll^Fp, Aa^Fpa
Aa^Fma, Aa^Fma, Aa^Fma, Gll^Fmw, Aa^Fma, Aa^Fma, Aa, Aa^Fma, Aa, Aa^Fma, Gll^Fmw, Aa^Fma, Gll^Fmw, Gll^Fmw, Gll^Fmw, Aa^Fma, Aa^Fma, Aa^Fma, Aa^Fma, Gll^Fmw, Aa^Fma, Aa^Fma, Aa, Aa^Fma, Aa^Fma, Ww, Ww, Ww, Ww, Aa^Fpa, Gd, Aa^Fpa, Aa, Aa, Aa, Aa, Aa^Fma, Aa, Aa^Fma, Aa, Aa^Fma, Aa^Fma, Aa^Fma, Aa, Aa, Aa^Fma, Aa, Gll^Fmw, Gll^Fmw, Aa^Fpa, Gll^Fp, Gll^Fp
Aa^Fma, Aa^Fma, Aa^Fma, Gll^Fmw, Aa^Fma, Gll^Fmw, Aa, Aa^Fma, Aa^Fma, Aa^Fma, Aa^Fma, Aa^Fma, Aa^Fma, Aa, Aa, Aa^Fma, Aa, Gll^Fmw, Aa^Fma, Gll^Fmw, Aa, Gll^Fmw, Aa^Fma, Aa^Fma, Aa^Fma, Ww, Ww, Gll^Fp, Ww, Aa^Fpa, Gll^Fmw, Aa^Fpa, Aa^Fpa, Aa^Fma, Aa, Aa^Fma, Aa^Fma, Aa^Fma, Aa^Fma, Aa^Fma, Aa, Aa^Fma, Aa^Fma, Aa^Fma, Aa, Aa^Fma, Aa^Fma, Aa, Gll^Fmw, Gd, Aa^Fpa, Gll^Fp
Aa^Fma, Aa, Gll^Fmw, Aa, Aa^Fma, Aa, Aa^Fma, Aa^Fma, Aa^Fma, Gll^Fmw, Aa^Fma, Aa^Fma, Aa^Fma, Aa^Fma, Aa^Fma, Aa^Fma, Aa^Fma, Gll^Fmw, Aa^Fma, Aa, Aa^Fma, Gll^Fmw, Aa^Fma, Aa^Fma, Aa, Gll^Fp, Ww, Gd^Vh, Ww, Aa, Gll^Fmw, Aa, Aa, Aa^Fpa, Aa, Aa, Aa, Aa, Aa, Aa^Fma, Aa^Fma, Aa^Fma, Aa^Fma, Aa, Aa^Fma, Aa^Fma, Aa^Fma, Aa^Fma, Aa, Aa, Gd, Gll^Fp
Re, Aa^Fma, Aa^Fma, Gll^Fmw, Aa, Aa^Fma, Gll^Fmw, Aa, Aa^Fma, Aa, Gll^Fmw, Aa, Aa^Fma, Aa^Fma, Aa, Aa^Feta, Aa^Fma, Gll^Fmw, Aa^Fma, Aa^Fma, Aa^Fma, Aa^Fma, Aa, Aa^Fma, Gd, Gd, Ww, Ww, Ww, Aa^Fpa, Aa^Fpa, Aa, Aa, Aa, Gd, Gd, Aa, Aa, Aa, Aa, Aa, Aa, Aa, Aa, Aa, Aa^Fma, Aa, Aa^Fma, Aa, Aa, Aa, Aa^Fpa
Re, Aa^Fpa, Gd, Aa^Fma, Aa^Fma, Aa^Fma, Aa, Gll^Fmw, Aa^Fma, Aa^Fma, Aa^Fma, Gll^Fmw, Aa^Fma, Aa^Fma, Gll^Fmw, Aa, Gll^Fmw, Aa, Aa^Fma, Aa^Fma, Aa^Fma, Aa, Gd, Aa, Gll^Fp, Ww, Ww, Ww, Gll^Fp, Aa^Fpa, Gd, Aa, Aa, Gd, Gd, Aa^Fpa, Aa, Aa, Aa, Aa, Aa, Aa^Vha, Aa, Aa, Aa, Aa, Aa, Aa, Aa, Aa, Aa, Aa
Gd, Gll^Fp, Gd, Aa, Aa, Aa, Aa^Vha, Re, Aa, Aa^Fma, Aa, Aa^Fma, Aa, Aa^Fma, Aa^Fma, Aa^Fma, Aa, Aa^Fma, Aa, Aa^Fma, Aa, Aa, Aa, Gd, Aa^Fpa, Ww, Ww, Ww, Ww, Gd, Aa, Aa, Aa, Gd, Gd, Gd, Gd, Gd, Aa, Aa, Aa, Aa, Aa, Aa, Ha, Ha, Ha, Aa, Aa, Aa, Aa, Aa
Gd, Gd, Gll^Fp, Gd, Aa, Aa, Aa, Re, Aa, Gd, Aa^Fpa, Aa^Fpa, Gd, Aa, Aa, Aa^Fma, Aa, Aa, Aa, Aa, Aa, Aa, Aa, Gd, Aa^Fpa, Gll^Fp, Gll^Fp, Ww, Ww, Aa, Aa, Aa, Aa, Gd, Gd, Gd, Aa^Fpa, Aa^Fpa, Gd, Aa, Aa, Aa, Aa, Ha, Ms, Ms^Feta, Ms, Aa, Aa, Gd, Gd, Gd
Gd, Gd, Gd, Aa^Fpa, Gd, Aa, Aa, Re, Aa, Gd, Aa^Fpa, Aa^Fpa, Aa^Fpa, Gd, Gd, Aa, Aa, Aa, Aa, Gd, Aa, Aa, Aa, Aa, Gd, Aa^Fpa, Aa^Fpa, Aa^Vha, Ai, Aa, Aa, Aa, Aa, Aa, Aa, Gd, Aa^Vha, Aa^Fpa, Gd, Gd, Gd, Aa, Aa, Ha, Ms, Ms, Aa, Aa, Aa, Aa^Fpa, Aa^Vha, Aa^Fpa
Gd, Gd, Gd, Gll^Fp, Aa^Fpa, Aa, Re, Re, Aa^Fpa, Aa^Fpa, Gll^Fp, Gll^Fp, Aa^Fpa, Aa^Fpa, Gd, Gd, Aa, Aa, Aa, Aa, Gd, Aa, Aa, Aa, Aa, Aa, Gd, Gd, Ai, Aa, Ai, Ai, Ai, Aa, Aa, Gd, Aa^Fpa, Aa^Fpa, Gd, Gd, Gd, Gd, Aa, Aa, Ha, Ha, Aa, Aa, Gd, Aa^Fpa, Aa^Fpa, Aa^Fpa
Gd, Gd, Gd, Gd, Gd, Gd, Re, Aa, Aa^Fpa, Gll^Fp, Gll^Fp, Gll^Fp, Aa^Fpa, Gd, Aa, Gd, Aa, Aa, Aa, Aa, Aa, Aa, Aa, Aa, Aa, Gd, Aa, Aa, Aa, Ai, Ai, Ai, Ai, Aa, Aa, Aa, Gd, Aa^Fpa, Gll^Fp, Gd, Gd, Aa^Fpa, Aa, Aa, Aa, Aa, Aa, Aa, Gd, Aa^Fpa, Aa^Fpa, Gll^Fp
Aa^Fpa, Gll^Fp, Gd, Gd, Gd, Gd, Re, Aa, Aa^Fpa, Gll^Fp, Gll^Fp, Aa^Fpa, Aa^Vha, Aa^Fpa, Aa^Fpa, Aa^Fpa, Gd, Aa, Aa, Aa, Aa, Aa, Aa, Aa, Gd, Gd, Gd, Aa, Aa, Aa, Aa, Ai, Ai, Ai, Aa, Aa, Gd, Aa^Fpa, Aa^Fpa, Aa^Fpa, Aa^Fpa, Aa^Fpa, Gd, Aa, Aa, Aa, Aa, Aa, Gd, Aa^Fpa, Gd, Gd
Gd, Aa, Gll^Fp, Gll^Fp, Gd, Gd, Gd, Re, Aa, Aa^Fpa, Aa^Fpa, Aa^Fpa, Gd, Gd, Cea, Cea, Cea, Aa, Aa, Aa, Aa, Aa, Aa, Aa^Fpa, Aa^Fpa, Aa^Fpa, Aa^Fpa, Gd, Aa, Aa, Ai, Ai, Aa, Aa, Aa, Aa, Gd, Gd, Aa^Fpa, Aa^Fpa, Gll^Fp, Aa^Vha, Aa^Fpa, Gd, Aa, Aa, Aa, Gd, Aa^Fpa, Aa^Fpa, Gll^Fp, Aa^Fpa
Aa, Gd, Gll^Fp, Gd, Gll^Fp, Aa^Fpa, Gd, Re, Re, Aa, Aa, Aa, Aa, Aa, Cea, 1 Kea, Cea, Aa, Aa, Aa, Aa, Aa, Gd, Aa, Aa^Fpa, Gll^Fp, Gll^Fp, Aa, Aa, Aa, Ai, Ai, Aa, Ha, Ha, Aa, Aa, Aa, Gd, Gll^Fp, Gd, Gll^Fp, Aa^Fpa, Gd, Aa, Gd, Gd, Aa^Fpa, Aa^Fpa, Aa^Fpa, Gd, Gd
Aa, Gd, Aa, Gll^Fp, Gll^Fp, Aa, Aa^Fpa, Aa, Re, Aa, Aa, Aa, Aa, Aa, Gd, Cea, Aa, Aa, Aa, Aa, Aa, Aa, Aa, Aa^Fpa, Aa, Gll^Fp, Gd, Aa^Fpa, Aa, Aa, Ai, Ai, Aa, Ha, Aa, Aa, Aa, Aa, Aa, Aa^Fpa, Gd, Gll^Fp, Aa^Fpa, Gd, Gd, Gd, Aa, Aa, Aa^Fpa, Aa^Fpa, Gd, Gd
Aa, Aa, Gd, Aa^Fpa, Aa^Fpa, Aa^Fpa, Aa^Vha, Gd, Aa, Re, Re, Ai, Aa, Gd, Gd, Aa, Gd, Gd, Aa, Aa, Aa, Aa, Aa, Gd, Aa^Fpa, Aa^Fpa, Aa^Fpa, Aa^Fpa, Aa, Ai, Ai, Aa, Aa, Aa, Aa, Aa, Aa, Aa, Aa^Fpa, Gll^Fp, Gd, Gd, Gll^Fp, Aa^Fpa, Gd, Gd, Aa, Aa^Fpa, Aa^Vha, Gd, Gd, Aa
Aa, Aa, Aa, Gd, Aa^Fpa, Aa, Aa^Fpa, Gd, Aa, Aa, Aa, Re, Re, Gd, Gd, Aa, Gd, Aa^Fpa, Gd, Gd, Gd, Gd, Aa, Gd, Gd, Gd, Gd, Aa, Aa, Ai, Ai, Aa, Aa, Aa, Gd, Gd, Aa, Aa, Gd, Gll^Fp, Gd, Gd, Gd, Gd, Aa^Fpa, Aa^Fpa, Aa, Gd, Gd, Gd, Gd, Gd
Aa, Aa, Aa, Gd, Gd, Aa^Fpa, Gd, Gd, Aa, Aa, Aa, Ww, Re, Gd^Vh, Gd, Aa, Gd, Gd, Aa^Fpa, Gd, Aa^Fpa, Gd, Gd, Aa, Gd, Gd, Ww, Ai, Ai, Ai, Aa, Aa, Aa, Gd, Gd, Gd, Gd, Gd, Gd, Aa^Fpa, Gll^Fp, Gd, Gd, Gd, Aa^Fpa, Aa, Gd, Aa, Aa, Gd, Gd, Gd
Ai, Aa, Aa, Aa, Aa, Aa, Aa, Aa, Ha, Aa, Aa, Aa, Gd, Re, Aa, Aa, Aa, Aa^Fpa, Gll^Fp, Gll^Fp, Aa^Fpa, Aa^Vha, Aa^Fpa, Ww, Ha, Ai, Ai, Aa, Aa, Aa, Aa, Aa, Gd, Gd, Gd, Gd, Gd, Gd, Gd, Aa, Gll^Fp, Gd, Gll^Fp, Gd, Aa^Fpa, Gd, Aa, Aa, Aa, Aa, Aa, Gd
Aa, Ai, Ai, Aa, Aa, Aa, Ha, Aa, Ha, Aa, Aa, Aa, Ai, Re, Aa, Aa, Aa, Aa, Aa^Fpa, Gll^Fp, Gd, Aa^Fpa, Hhd, Ww, Ai, Ai, Ai, Ai, Aa, Aa, Gd, Aa^Fpa, Gd, Gd, Aa^Fpa, Aa, Gd, Gd, Gd, Aa^Fpa, Gd, Aa^Fpa, Gd, Aa^Fpa, Gd, Aa, Aa, Aa, Aa, Aa, Aa, Aa
Ai, Ai, Ai, Aa, Ha, Ha, Ms, Ms, Aa, Aa, Aa, Ai, Ai, Re, Re, Gd, Gd, Aa^Fpa, Aa, Aa^Fpa, Aa^Fpa, Hhd, Hhd, Hhd, Ww, Ww, Ww, Ww, Gd^Vh, Aa^Fpa, Aa, Aa^Fpa, Aa^Fpa, Aa, Aa^Fpa, Aa^Fpa, Aa^Fpa, Gd, Aa^Fpa, Gll^Fp, Aa^Fpa, Aa^Fpa, Aa^Vha, Gd, Gd, Aa, Coa, Aa, Aa, Aa, Aa, Aa
Ai, Ai, Aa, Aa, Aa, Ha, Ha, Ha, Ai, Ai, Ai, Ai, Ai, Ai, Re, Aa, Gd, Gd, Aa^Fpa, Aa^Fpa, Gd, Hhd, Hhd, Hhd, Ww, Ww, Ww, Ww, Ww, Aa^Fpa, Aa^Fpa, Aa^Fpa, Aa^Fpa, Aa^Fpa, Gd, Aa^Fpa, Aa, Aa, Aa^Fpa, Gd, Gll^Fp, Gll^Fp, Aa^Fpa, Gd, Coa, Coa, 2 Koa, Coa, Aa, Aa, Aa, Aa
Aa, Aa, Aa, Aa, Gd, Aa, Aa^Vha, Aa, Ai, Ai, Aa, Ai, Ww, Ww, Re, Gd, Gd, Gd, Aa, Aa, Aa, Hhd, Hhd, Hhd^Vhh, Ww, Ww, Ww, Ww, Aa^Fpa, Gll^Fp, Aa^Fpa, Gll^Fp, Aa^Fpa, Aa, Gd, Gd, Gd, Aa^Fpa, Aa^Fpa, Gd, Gd, Gd, Gll^Fp, Aa^Fpa, Aa, Coa, Coa, Aa, Aa, Aa, Aa, Gd
Aa, Aa, Aa, Aa, Aa, Gd, Gd, Aa, Ai, Aa, Aa, Ai, Ww, Ww, Re, Gd, Gd, Gd, Gd, Aa, Aa, Gd, Hhd, Hhd, Hhd, Hhd, Hhd, Hhd, Aa^Fpa, Aa^Fpa, Aa, Aa^Fpa, Aa^Fpa, Aa^Fpa, Gd, Gd, Gd, Aa, Gll^Fp, Gd, Gd, Gd, Gll^Fp, Aa^Fpa, Aa, Aa, Aa, Aa, Aa, Aa, Aa, Aa^Fpa
Aa, Aa, Gd, Aa, Gd, Gd, Aa, Aa, Ai, Ai, Ai, Aa, Aa, Re, Gd, Aa^Fpa, Gd, Aa, Aa, Aa, Aa, Gd, Hhd, Hhd, Hhd, Hhd, Hhd, Hhd, Hhd, Hhd, Aa^Fpa, Aa^Fpa, Aa^Fpa, Aa^Vha, Aa^Fpa, Gd, Gd, Aa^Fpa, Gd, Gd, Gll^Fp, Gll^Fp, Aa^Fpa, Aa^Fpa, Gd, Aa, Aa, Aa, Aa, Aa, Gd, Aa^Fpa
Aa, Aa, Gd, Gd, Aa^Fpa, Gd, Gd, Aa, Aa, Aa, Ai, Ai, Aa, Re, Gd, Gd, Aa, Aa, Aa, Aa, Aa, Gd, Gd, Hhd, Hhd, Hhd, Hhd, Ha, Ha, Ha, Hhd, Aa, Aa^Fpa, Aa^Fpa, Gd, Gd, Gd, Aa, Gd, Aa^Fpa, Aa^Fpa, Aa^Fpa, Aa^Fpa, Aa, Gd, Gd, Aa^Fpa, Gd, Aa, Aa, Gd, Aa^Fpa
Aa, Aa, Gd, Gd, Aa^Fpa, Aa^Fpa, Gd, Aa, Aa, Ai, Aa, Aa, Aa^Vha, Re, Aa, Aa, Aa, Aa, Aa, Aa, Aa, Aa, Aa, Ha, Ms, Ms, Ms, Ha, Ha, Ha, Ha, Hhd, Aa^Fpa, Aa, Aa^Fpa, Gd, Gd, Aa, Aa, Aa, Aa, Aa, Gd, Gd, Gd, Aa^Fpa, Gd, Gd, Aa, Aa, Gd^Vh, Aa^Fpa
Aa, Aa, Aa, Aa, Gd, Gd, Gd, Aa, Aa, Ai, Aa, Aa, Aa, Re, Aa, Aa, Aa, Aa, Aa, Aa, Aa, Aa, Ha, Ms, Ms, Ms, Ha, Ha^Vhha, Ha, Ha, Ha, Hhd, Aa^Fpa, Gll^Fp, Gll^Fp, Aa^Fpa, Gd, Aa, Aa, Aa, Aa, Gd, Gd, Aa^Fpa, Gd, Gd, Aa^Fpa, Aa^Fpa, Aa^Fpa, Gd, Gd, Ww
Aa, Aa, Aa, Aa, Aa, Aa, Aa, Ai, Ai, Ai, Aa, Aa, Aa, Re, Aa, Aa, Aa, Aa, Aa, Aa, Aa, Aa, Ha, Ms, Ha, Hhd, Ha, Ha, Ha, Aa, Ha, Ha, Aa^Fpa, Gll^Fp, Gll^Fp, Aa^Fpa, Gd, Gd, Gd, Gd, Gd, Aa^Fpa, Aa^Fpa, Aa^Vha, Aa^Fpa, Gd, Aa^Fpa, Gll^Fp, Aa^Fpa, Aa^Fpa, Gd, Ww
Aa, Aa, Aa, Aa, Ai, Aa, Aa, Ai, Aa, Aa, Aa, Aa, Aa, Re, Aa, Aa, Aa, Aa, Aa, Aa, Aa, Ha, Hhd, Hhd, Hhd, Hhd, Hhd, Ha, Aa, Aa, Aa, Gd, Aa, Aa, Aa, Aa, Aa^Fpa, Gd, Gd, Aa^Fpa, Gll^Fp, Gd, Gd, Aa^Fpa, Aa, Aa, Gd, Aa^Fpa, Gll^Fp, Gd, Ai, Ai
Aa, Aa, Aa, Aa, Ai, Ai, Ai, Ai, Aa, Aa, Aa, Aa, Re, Re, Aa, Aa, Aa, Gd, Gd, Aa, Ha, Hhd, Hhd, Hhd, Aa^Fpa, Aa^Fpa, Gd, Aa, Aa, Aa, Aa, Gd, Aa^Fpa, Aa^Fpa, Aa^Fpa, Gd, Aa, Aa, Gd, Aa^Fpa, Gd, Gd, Gd, Aa^Fpa, Aa, Aa, Gd, Gd, Gd, Gd, Aa, Ai
Aa, Aa, Aa, Gd, Ww, Ww, Ww, Ww, Aa, Aa, Aa, Re, Gd, Gd, Aa^Fpa, Gd, Aa, Aa^Fpa, Aa^Fpa, Gd, Gd, Hhd, Hhd, Aa^Fpa, Aa^Fpa, Aa^Fpa, Gd, Aa, Aa, Aa, Aa, Aa, Gd, Gd, Gd, Aa, Aa, Aa, Gd, Aa, Gd, Gd, Gd, Aa, Aa, Aa, Aa, Gd, Aa, Aa, Aa, Ai
Aa, Aa, Aa, Aa, Ww, Aa^Fpa, Ww, Ww, Gd, Aa, Aa, Re, Aa^Fpa, Aa^Fpa, Aa^Fpa, Aa^Fpa, Aa^Fpa, Aa^Fpa, Aa^Fpa, Aa^Vha, Gd, Gd, Gd, Aa^Fpa, Gd, Gd, Gd, Aa, Aa, Gd, Gd, Aa, Aa, Gd, Aa^Vha, Aa, Aa, Aa, Aa, Aa^Fpa, Aa^Fpa, Aa^Fpa, Gd, Gd, Aa, Aa, Gd, Gd, Gd, Aa, Aa, Ai
Aa^Fpa, Gd, Gd, Gd, Ww, Ww, Aa^Fpa, Aa^Vha, Gd, Aa, Aa, Re, Aa, Aa^Vha, Gll^Fp, Gll^Fp, Gll^Fp, Gll^Fp, Aa^Fpa, Aa, Gd, Gd, Aa^Fpa, Aa^Fpa, Aa, Gd^Vh, Gd, Aa, Aa, Aa, Gd, Gd, Gd, Aa, Aa, Aa, Aa, Aa, Aa, Aa, Aa, Aa, Aa, Aa, Aa, Aa, Gd, Gd, Gd, Gd, Aa, Ai
Aa^Fpa, Gd, Gd, Gd^Vh, Ww, Aa^Fpa, Aa^Fpa, Gd, Aa, Aa, Aa, Re, Gd, Aa^Fpa, Aa^Fpa, Gll^Fp, Gll^Fp, Gd, Aa^Fpa, Gd, Gd, Gd, Gd, Aa, Gd, Gd, Gd, Aa, Aa, Aa, Gd, Gd, Aa, Aa, Aa, Aa, Ha, Aa, Aa, Aa, Aa, Aa, Aa, Aa, Aa, Gd, Gd, Gd, Gd^Vh, Gd, Aa, Ai
Aa^Fpa, Aa^Fpa, Ww, Ww, Aa, Gd, Gd, Gd, Aa, Aa, Aa, Re, Aa, Aa, Aa^Fpa, Aa, Gd, Gll^Fp, Aa^Fpa, Gd, Gd, Aa, Gd, Gd, Gd, Aa, Aa, Aa, Aa, Aa, Gd, Gd, Gd, Aa, Aa, Ha, Ha, Aa, Aa, Aa, Aa, Aa, Aa, Aa, Gd, Gd, Gd, Gd, Ww, Ww, Ai, Ai
Aa^Fpa, Gd, Ai, Ai, Aa, Aa, Aa, Aa, Ms, Aa, Aa, Re, Re, Gd, Gd, Aa, Aa^Fpa, Aa^Fpa, Gd, Aa, Aa, Aa, Aa, Aa, Gd, Aa, Aa, Aa, Ms, Aa, Ha, Aa, Aa, Aa, Aa, Ha, Ms, Ha, Aa, Aa, Aa, Aa, Aa, Aa, Aa, Gd, Coa, Coa, Ai, Ai, Ai, Ai
Aa^Fpa, Ai, Ai, Aa, Aa, Aa, Aa, Ms, Ms, Aa, Aa, Gd, Aa, Re, Aa, Gd, Gd, Aa, Aa, Aa, Aa, Aa, Aa, Aa, Aa, Aa, Ha, Ms, Ms, Ha, Ha, Aa, Aa, Aa, Ha, Ha, Ms, Ha, Ha, Aa, Aa, Aa^Vha, Aa, Aa, Aa, Coa, 4 Koa, Coa, Gd, Ai, Ai, Ai
Ai, Aa, Aa, Ai, Ai, Aa, Ha, Ms, Ha, Aa, Gd, Gd, Aa, Re, Re, Aa, Aa, Aa, Aa, Aa^Vha, Aa, Aa, Aa, Aa, Aa, Aa, Ha, Ha, Ms, Ms, Ha, Aa, Aa^Vha, Ha, Ms, Ms, Ha, Ha^Fpa, Aa, Aa, Aa, Aa, Aa, Aa, Aa, Coa, Gd, Gd, Aa, Gd, Ww, Ai
Aa, Ai, Ai, Aa, Ai, Aa, Ha, Ha, Aa, Aa, Gd, Gd, Gd, Aa, Aa, Re, Aa, Aa, Aa, Aa, Aa, Aa, Aa, Aa, Aa, Ha, Ha, Ms, Ha^Fpa, Ms, Aa, Aa, Aa, Ha^Fpa, Ha, Aa, Ha, Aa, Aa, Aa, Gd, Aa, Aa, Aa, Aa, Aa, Aa^Fpa, Aa, Gll^Fp, Ww, Ww, Ww
Ai, Ai, Ai, Ai, Ai, Ww, Gd^Vh, Gd, Aa, Gd, Gd, Gd, Gd, Aa^Fpa, Aa, Re, Re, Aa, Aa, Aa, Aa, Aa, Aa, Aa, Aa, Aa^Vha, Aa, Ha^Fpa, Aa, Ha, Aa, Aa, Aa, Ha, Aa, Ha, Ha, Ha, Aa, Gd, Aa, Aa, Aa, Aa, Aa, Aa, Gd, Aa^Fpa, Gd, Ww, Ww, Ww
Ai, Ai, Aa, Ww, Ww, Ww, Ww, Gd, Gd, Gd, Aa^Fpa, Aa^Fpa, Aa^Fpa, Gd, Gd, Aa, Aa, Re, Aa, Aa, Aa, Aa, Aa, Aa, Aa, Aa, Aa, Aa, Aa, Aa, Aa, Aa, Aa, Aa, Aa, Aa, Aa, Aa, Gd, Aa, Aa, Aa, Aa, Aa, Aa, Aa, Gd, Aa, Gd, Gd^Vh, Ww, Ww
Ai, Ai, Ww, Ww, Ww, Ww, Ww, Aa^Fpa, Gd, Aa^Fpa, Aa^Fpa, Aa^Fpa, Re, Gd, Aa, Aa, Re, Re, Re, Re, Re, Aa, Aa, Aa, Gd, Gd, Gd, Gd, Gd, Aa, Aa, Aa, Ai, Ai, Ai, Aa, Aa, Aa, Aa, Aa, Aa, Aa, Aa, Aa, Aa, Aa, Gd, Aa^Fpa, Gll^Fp, Gll^Fp, Gll^Fp, Gll^Fp
Gd, Ww, Gd, Gd, Ai, Ai, Ww, Gd, Gd, Gd, Aa^Fpa, Re, Aa^Fpa, Re, Re, Re, Aa^Fpa, Aa, Aa, Aa^Fpa, Re, Aa, Aa, Aa, Gd, Aa^Fpa, Gd, Gll^Fp, Aa^Fpa, Gd, Ww, Ai, Ai, Ai, Ai, Aa, Aa, Aa, Aa, Aa, Ai, Aa, Aa, Aa, Gd, Aa, Aa, Gd, Aa^Fpa, Aa^Fpa, Gd, Aa^Fpa
Gd, Gd, Gd, Aa, Ai, Ai, Aa, Aa, Aa, Gd, Gd, Re, Gd, Aa^Fpa, Gd, Aa^Fpa, Aa^Vha, Aa^Fpa, Aa^Fpa, Aa^Fpa, Gd, Re, Aa, Aa, Gd, Aa, Gd, Gd, Gll^Fp, Aa^Fpa, Gd, Ai, Ai, Ai, Ww, Ww, Ww, Ai, Ww, Ww, Ww, Aa^Fpa, Ww, Ww, Ww, Gd, Ai, Aa, Aa, Aa, Ai, Ww
Aa^Fpa, Gd, Gd, Gd, Aa, Aa, Aa, Aa, Aa, Aa, Re, Coa, Coa, Coa, Aa^Fpa, Aa^Fpa, Aa^Fpa, Aa^Fpa, Aa, Aa^Fpa, Gd, Re, Aa, Aa, Gd, Aa, Gll^Fp, Gd, Gd, Ww, Ww, Ww, Ww, Ww, Ww, Ww, Aa, Ai, Gd, Aa, Gll^Fp, Ww, Aa^Vha, Aa^Fpa, Ww, Ww, Aa, Ai, Ai, Ai, Ai, Ww
Re, Re, Re, Re, Re, Re, Re, Aa, Aa, Re, Gd, Coa, 3 Koa, Coa, Aa^Fpa, Gd, Aa, Aa^Fpa, Aa^Fpa, Aa^Vha, Aa, Re, Re, Gd, Aa^Fpa, Aa^Fpa, Gll^Fp, Gd, Gll^Fp, Gll^Fp, Aa^Fpa, Hhd, Ww, Ai, Ww, Ai, Aa, Aa, Gd, Aa, Aa^Fpa, Aa^Fpa, Aa, Gd, Gd, Aa^Fpa, Gd, Gd, Gd, Ai, Ai, Ww
Gd, Aa^Fpa, Gd, Aa, Aa, Aa, Aa, Re, Re, Re, Gd, Aa^Fpa, Coa, Aa^Fpa, Gd, Gd, Aa^Fpa, Gd, Gd, Aa, Aa^Fpa, Gd, Re, Gd, Aa, Aa^Fpa, Aa, Aa^Fpa, Aa^Fpa, Hhd, Hhd, Hhd, Ha, Ww, Ai, Ha, Aa, Gd, Aa, Aa^Fpa, Gll^Fp, Aa, Aa^Fpa, Gd, Gd, Gd, Aa^Fpa, Aa^Fpa, Gd, Ww, Ai, Aa
Aa^Fpa, Aa, Aa, Aa, Aa, Aa, Aa, Aa, Gd, Gd, Aa, Aa^Fpa, Aa^Fpa, Gd, Aa, Aa, Gd, Gd, Aa, Gd, Gd, Gd, Re, Gd, Aa^Fpa, Gd, Aa, Aa, Aa, Hhd, Mm, Hhd, Hhd, Ww, Ha^Vhha, Ha, Aa, Gd, Gd, Aa^Fpa, Aa, Aa^Fpa, Aa, Gd, Gd, Gd, Gd, Gd, Gd, Ai, Ai, Aa
Gd, Aa, Aa, Aa, Aa, Aa, Aa, Gd, Aa^Vha, Aa^Fpa, Aa^Fpa, Aa, Aa^Fpa, Gd, Aa, Aa, Aa, Aa, Aa, Aa, Aa, Aa, Re, Aa, Gd, Gd, Aa, Aa, Ms, Ha, Hhd, Mm, Hhd, Ha, Ha, Ha, Ha, Aa, Aa, Aa, Gd, Aa^Fpa, Gd, Gd, Aa^Fpa, Gd, Gd, Gd, Gd, Ai, Ai, Ai
Gd, Aa, Aa, Aa, Aa, Aa, Gd, Aa^Fpa, Aa, Aa^Fpa, Aa, Aa, Aa, Gd, Aa, Gd, Gd, Gd, Gd, Gd, Aa, Aa, Gd, Re, Re, Ha, Ha, Ms, Ha, Ha, Hhd, Mm, Hhd, Ha, Ha, Ha, Ha, Aa, Aa, Aa, Aa, Aa, Gd, Gd, Aa^Fpa, Gd, Gd, Gd^Vh, Ww, Ai, Ai, Ai
Aa, Gd, Aa, Aa, Aa, Gd, Gd, Gd, Gd, Aa^Fpa, Aa, Aa, Aa^Fpa, Gd, Gd, Gd, Gd, Gd, Gd, Gd, Aa, Aa, Aa, Aa, Gd, Re, Re, Ha, Re, Ha, Ha, Re, Hhd, Gd, Ha, Ha, Aa, Aa, Aa, Aa, Re, Re, Re, Aa^Fpa, Re, Aa^Fpa, Gd, Gd, Ww, Ai, Ai, Aa
