Mm, Mm, Mm, Mm, Mm, Mm, Mm, Mm, Mm, Mm, Mm, Mm, Mm, Mm, Mm, Mm, Mm, Mm, Mm, Mm, Mm, Mm, Mm, Mm, Mm, Mm, Mm, Mm, Mm, Hh, Re, Rd, Re, Re, Re, Re, Rd, Re, Re, Rd, Rd, Rd, Re, Re, Rd, Rd, Rd
Mm, Mm, Mm, Mm, Mm, Mm, Mm^Xm, Mm, Mm, Mm, Mm, Mm, Mm^Xm, Mm, Mm^Xm, Mm, Mm, Mm, Mm, Mm, Mm, Mm, Mm, Mm, Mm, Mm, Mm, Mm, Mm, Hh, Re, Re, Rd, Re, Re, Rd, Rd, Re, Re, Re, Re, Re, Re, Re, Re, Re^Es, Rd
Mm, Mm, Mm, Mm, Mm^Xm, Mm^Xm, Mm, Mm^Xm, Mm, Mm, Mm, Mm^Xm, Mm, Mm^Xm, Mm, Mm, Mm, Mm, Mm, Mm, Mm, Mm, Mm, Mm, Mm, Mm, Mm, Mm, Mm, Hh, Re, Rd, Rd, Re, Re, Re, Rd, Rd, Rd, Re, Re, Re, Ur, Ur, Ur, Re, Re
Mm, Mm, Mm^Xm, Mm^Xm, Mm^Xm, Mm, Hh, Mm, Hh, Mm, Hh, Hh, Mm, Mm, Mm, Mm, Hh, Mm, Mm, Mm, Mm, Mm, Mm, Mm, Mm, Mm, Mm, Mm, Hh, Hh, Re, Rd, Re, Re^Vct, Re, Re, Rd, Rd, Re, Re, Re, Ur, Uu, Uu, Uu, Ur, Re
Mm, Mm, Mm, Mm, Mm^Xm, Mm, Hh, Hh, Gg, Hh, Gg^Efm, Hh, Hh, Hh, Hh, Hh, Gs^Fds, Hh, Hh, Mm, Hh, Mm, Mm, Hh, Hh, Mm, Hh, Mm, Hh, Re, Re, Re, Re, Re, Re, Rd, Re, Re, Re, Re, Re, Ur, Uu, Yl, Uu, Ur, Re
Mm, Mm^Xm, Mm^Xm, Mm, Mm, Mm, Hh, Gg, Re, Gg, Gg^Efm, Gg^Efm, Gg^Efm, Hh, Hh, Gs^Fds, Gs^Fds, Gg, Gg, Hh, Gg, Hh, Mm, Hh, Dd, Hh, Dd, Hh, Hh, Re, Re, Rd, Re, Rd, Rd, Rd, Re, Re, Re, Re, Rd, Ur, Ur, Uu, Ur, Ur, Re
Mm, Mm, Mm, Mm, Hh, Hh, Re, Re, Gg^Efm, Re, Re, Re, Re, Gg, Gg, Gs^Fds, Gg, Gg, Gg^Efm, Hh, Gg, Hh, Hh, Hh, Dd, Dd, Dd, Dd, Hh, Hh, Re, Rd, Re, Rd, Re, Rd, Re, Re, Co, Rd, Rd, Rd, Re, Ur, Re, Re, Re
Mm, Mm, Mm, Hh, Hh, Gg, Re, Gg, Re, Re, Gg, Re, Gg, Gg, Gg, Gg, Rd, Gg^Efm, Gg, Gg, Gs^Fds, Gg, Gg, Gg, Gg, Dd, Dd, Dd, Re, Re, Rd, Rd, Re, Re, Re, Re, Re, Co, 2 Ko, Co, Rd, Rd, Re, Re, Re, Re, Rd
Mm, Mm, Hh, Hh, Gg^Efm, Gg^Efm, Re, Re, Re, Re, Re, Gs^Fds, Gs^Fds, Gg, Gg, Rd, Gg, Gg^Efm, Gg^Efm, Gg, Gg, Gs^Fds, Gg, Re, Re, Gg^Efm, Gg^Efm, Dd, Dd, Re, Re, Re, Rd, Re, Re, Re, Re, Co, Co, Co, Rd, Rd, Re, Re, Rd, Rd, Re
Hh, Hh, Gg, Gg, Re, Re, Re, Re, Re, Gg, Re, Gg, Gg, Gg, Rd, Gg, Gg^Efm, Gg^Efm, Gg, Re, Re, Gg, Gg, Re, Re, Rd, Gg, Dd, Dd, Re, Re, Re, Rd, Rd, Re, Re, Re, Re, Rd, Rd, Rd, Rd, Re, Rd, Re, Re, Re
Ww, Gg, Re, Re, Gg^Efm, Re, Gg, Gg, Re, Re, Re, Re, Gg, Gg^Efm, Re, Gg, Gg, Gg^Efm, Re, Re, Re, Re, Gg, Re, Re, Rd, Gg, Dd, Dd, Dd, Re, Re, Rd, Re, Rd, Re, Re, Re, Re, Rd, Re, Re, Re, Rd, Rd, Re, Re
Dd, Ww, Ww, Gg, Rd, Gg^Efm, Gg^Efm, Re, Re, Re, Re, Re, Gg^Efm, Gg^Efm, Re, Re, Re, Re, Re, Gg^Efm, Re, Re, Gg^Efm, Re, Re, Gg^Efm, Gg^Ve, Dd, Dd, Dd, Re, Re, Rd, Re, Re, Rd, Re, Re, Re, Rd, Rd, Re, Re, Re, Re, Re, Re
Dd, Dd, Dd, Ww, Ww, Rd, Re, Re, Re, Re, Re, Re, Gg^Efm, Re, Re, Re, Gg, Re, Gg^Efm, Re, Re, Gg, Gg^Efm, Gg^Efm, Gg, Re, Gg, Gg, Gs^Fds, Dd, Dd, Re, Re, Rd, Re, Rd, Re, Re, Re, Rd, Re, Rd, Rd, Re, Re, Re, Re
Dd, Dd, Dd, Dd, Ww, Ww, Re, Re, Re, Re, Gg, Gg, Gg, Gg, Gg, Gg, Gg, Re, Gg^Efm, Re, Rb^Yc, Rb^Yc, Gg, Gg^Efm, Re, Gg, Gg, Gg, Gs^Fds, Dd, Dd, Re, Re, Re, Re, Rd, Re, Re, Re, Re, Re, Re, Re, Rd, Re, Re, Rd
Dd, Dd, Dd, Dd, Ww, Ww, Re, Re, Rd, Rd, Gg, Gg, Gg, Gg^Ve, Gg, Gg, Gs^Fds, Gg^Efm, Gg^Efm, Gg, Gg, Gg, Re, Re, Re, Gg, Hh, Hh, Hh, Gg, Gg, Dd, Dd, Re, Re, Re, Rd, Re, Re, Re, Re, Re, Re, Re, Re, Re, Rd
Dd, Dd, Dd, Dd, Ww, Ww, Gg, Gg, Gg, Gg, Gg^Efm, Gg^Efm, Gg, Gg, Gg, Gs^Fds, Gs^Fds, Gg, Gg^Yc, Gg^Yc, Gg, Gg, Re, Gg, Re, Gg, Hh, Mm, Hh, Hh, Gg, Dd, Dd, Re, Re, Rd, Re, Re, Re, Re^Vct, Re, Re, Re, Re, Re, Rd, Re
Dd, Dd, Dd, Dd, Ww, Gs^Fds, Gg, Rd, Gg, Gg^Efm, Gg, Re, Re, Re, Gg, Gs^Fds, Gg, Gg, Gg^Yc, Gg, Gg^Efm, Gg, Gg, Re, Gg, Gg, Hh, Mm, Hh, Gg, Gg^Efm, Dd, Dd, Dd, Dd, Rd, Re, Re, Rd, Rd, Re, Re, Rd, Re, Re, Re, Re
Dd, Dd, Dd, Dd, Ww, Gs^Fds, Rd, Gg, Re, Re, Re, Gg, Gg, Gg, Gg, Gg, Gg^Yc, Gg^Yc, Gg, Gg, Gg^Efm, Gg, Rd, Gg, Rd, Gg, Gg^Efm, Hh, Gg, Gg, Dd, Dd, Dd, Dd, Dd, Re, Re, Re, Re, Re, Re, Re, Re, Rd, Re, Re, Re
Dd, Dd, Dd, Ww, Ww, Gg, Re, Gg, Re, Gg, Gg, Gg, Gg, Gg, Gg^Yc, Gg^Yc, Gg, Gg^Efm, Re, Gg, Gg, Gg^Efm, Gg, Rd, Gg, Gg, Gg^Efm, Gg, Dd, Dd, Dd, Dd, Dd, Dd, Dd, Dd, Dd, Re, Rd, Rd, Re, Re, Re, Rd, Rd, Re, Re
Dd, Dd, Ww, Ww, Re, Re, Gg, Re, Gg, Gg, Gg, Gs^Fds, Gg, Gg^Yc, Gg, Gg, Gg, Re, Re, Re, Gg, Gg^Efm, Dd, Gg, Dd, Dd, Dd, Dd, Dd, Dd, Dd, Dd, Dd, Dd, Dd, Rd, Rd, Dd, Dd, Re, Dd, Re, Re, Re, Re, Re, Re
Dd, Dd, Ww, Gg, Gg^Efm, Gg^Efm, Gg^Efm, Gg, Re, Re, Gg, Gg, Gg, Gg, Gg^Efm, Gg^Efm, Re, Re, Gg, Gg, Dd, Dd, Dd, Dd, Dd, Dd, Dd, Dd, Dd, Dd, Dd, Dd, Dd, Dd, Dd, Dd, Rd, Dd, Dd, Dd, Dd, Dd, Dd, Re, Re, Re, Re
Dd, Dd, Ww, Gg^Efm, Gg^Efm, Gg^Efm, Gg, Re, Re, Gg, Re, Re, Re, Gg, Gg^Efm, Gg, Gg, Gg, Dd, Dd, Dd, Dd, Dd, Dd, Dd, Dd, Cud, Cud, Cud, Dd, Dd, Dd, Dd, Dd, Dd, Dd, Dd, Rd, Dd, Dd, Dd, Dd, Dd, Dd, Re, Re, Re
Dd, Dd, Ww, Gg, Rd, Gg^Efm, Re, Re, Gg, Re, Gg^Efm, Re, Gg, Gg^Efm, Gg, Gg, Gs^Fds, Gg, Dd, Dd, Dd, Dd, Dd, Dd, Dd, Dd, Cud, Ko, Cud, Dd, Dd, Dd, Dd, Dd, Dd, Dd, Dd, Rd, Dd, Dd, Dd, Dd, Dd, Dd, Dd, Dd, Dd
Dd, Dd, Ww, Rd, Gg, Gg, Re, Re, Gg, Gg, Gg, Gg, Gg, Gg, Gg, Gs^Fds, Gs^Fds, Dd, Dd, Dd, Rd, Dd, Dd, Dd, Dd, Dd, Dd, Cud, Dd, Dd, Dd, Dd, Dd, Dd, Dd, Dd, Dd, Dd, Rd, Dd, Dd, Dd, Rd, Dd, Dd, Dd, Dd
Dd, Dd, Ww, Gg, Gg, Gg, Re, Re, Gg, Gg^Ve, Gg, Ce, Ce, Ce, Gg, Gs^Fds, Dd, Dd, Dd, Dd, Dd, Rd, Dd, Dd, Dd, Dd, Dd, Dd, Dd, Dd, Dd, Dd, Dd, Dd, Dd, Dd, Dd, Rd, Dd, Dd, Dd, Dd, Rd, Dd, Dd, Dd, Dd
Ww, Ww, Rd, Rd, Gg, Gg, Re, Re, Re, Gg, Gg, Ce, 1 Ke, Ce, Gg, Gg, Dd, Dd, Dd, Dd, Dd, Dd, Dd, Rd, Dd, Rd, Dd, Dd, Dd, Dd, Dd, Dd, Dd, Dd, Dd, Dd, Dd, Rd, Dd, Dd, Dd, Rd, Dd, Dd, Dd, Dd, Dd
Ww, Gg, Gg^Efm, Gg^Efm, Re, Re, Re, Re, Re, Gg, Gg, Gg, Ce, Gg, Gg^Efm, Dd, Dd, Dd, Dd, Dd, Dd, Dd, Dd, Rd, Dd, Dd, Dd, Dd, Dd, Dd, Dd, Dd, Dd, Dd, Dd, Dd, Dd, Rd, Dd, Dd, Dd, Rd, Dd, Dd, Dd, Dd, Dd
Gs^Fds, Gg, Gg, Gg, Gg, Re, Gg, Re, Re, Re, Re, Gg, Gg, Gg, Dd, Dd, Dd, Dd, Dd, Dd, Dd, Dd, Dd, Dd, Dd, Dd, Dd, Dd, Dd, Dd, Rd, Dd, Dd, Dd, Dd, Dd, Dd, Dd^Vdt, Dd, Dd, Dd, Dd, Dd, Dd, Dd, Dd, Dd
Re, Gs^Fds, Gs^Fds, Gg, Gg^Efm, Gg, Rd, Gg, Gg, Re, Gg, Gg, Dd, Dd, Dd, Dd, Dd, Dd, Dd, Dd, Dd, Dd, Dd, Dd, Dd, Dd, Dd, Dd, Dd, Dd, Rd, Dd, Dd, Dd, Dd, Dd, Dd, Dd, Dd, Dd, Dd, Dd, Dd, Dd, Dd, Dd, Dd
Re, Re, Re, Re, Re, Gg^Efm, Gg^Efm, Gg^Efm, Gg, Gg, Dd, Dd, Dd, Dd, Dd, Dd, Dd, Dd, Dd, Dd, Rd, Dd, Rd, Rd, Dd, Dd, Dd, Dd, Dd, Dd, Dd, Rd, Dd, Dd, Dd, Dd, Dd, Dd, Dd, Dd, Dd, Dd, Rd, Rd, Rd, Dd, Dd
Re, Re, Re, Re, Gg, Gg, Dd, Gg^Efm, Dd, Dd, Dd, Dd, Dd, Dd, Dd, Dd, Dd, Dd, Dd, Dd, Dd, Dd, Dd, Dd, Dd, Dd, Dd, Dd, Dd, Dd, Dd, Rd, Dd, Dd, Dd, Dd, Dd, Dd, Dd, Dd, Dd, Dd, Rd, Dd, Dd, Dd, Dd
Re, Re, Ww, Re, Dd, Dd, Gg, Dd, Dd, Dd, Dd, Dd, Dd, Dd, Dd, Dd, Dd, Dd, Dd, Dd, Dd, Dd, Dd, Dd, Dd, Dd, Dd, Dd, Dd, Dd, Dd, Dd, Dd, Dd, Dd, Dd, Dd, Dd, Dd, Dd, Dd, Dd, Dd, Dd, Dd, Dd, Dd
