Xoi, Xoi, Xoi, Xoi, Xoi, Xoi, Xoi, Xoi, Xoi, Xoi, Xoi, Xoi, Xoi, Xoi, Xoi, Xoi, Xoi, Xoi, Xoi, Xoi, Xoi, Xoi, Xoi, Xoi, Xoi, Xoi, Xoi, Xoi, Xoi, Xoi, Xoi, Xoi
Xoi, Isr, 2 Kud, Isr, Ch, Iwr, Iwr, Xoi, Xoi, Xoi, Xoi, Xoi, Xoi, Xoi, Xoi, Xoi, Xoi, Xoi, Xoi, Xoi, Xoi, Xoi, Xoi^Efs, Xoi, Xoi, Xoi, Xoi, Xoi, Gg^Ve, Gg^Ve, Gg^Ve, Xoi
Xoi, Isr, Ch, Ch, Iwr, Iwr, Iwr, Xoi^Efs, Xoi^Efs, Xoi, Xoi, Xoi, Xoi, Xoi, Xoi, Xoi, Xoi, Xoi, Isr, Isr, Isr, Isr, Isr, Xoi^Efs, Xoi, Xoi, Xoi, Xoi, Xoi, Xoi, Xoi, Xoi
Xoi, Xoi, Iwr, Iwr, Iwr, Iwr, Iwc, Iwr, Xoi, Xoi, Xoi, Xoi, Xoi, Xoi, Xoi, Xoi, Xoi, Isr, Isr, Isr, Isr, Isr, Isr, Isr, Isr, Xoi, Xoi, Xoi, Xoi, Xoi, Xoi, Xoi
Xoi, Iwr, Iwr^TabY, Iwr^TabY, Iwc, Iwc, Iwc, Iwc, Iwr, Xoi, Iwr, Xoi^Efs, Iwr, Xoi^Efs, Iwr, Xoi, Xoi, Isr, Isr, Isr, Isr, Isr, Isr, Isr, Isr, Xoi, Xoi, Xoi, Xoi, Xoi, Xoi, Xoi
Xoi, Iwr, Iwr, Iwc, Iwc, Iwc, Xoi^Efs, Iwr, Iwr, Iwr, Iwr, Iwr, Iwr, Iwr, Iwr, Iwr, Xoi, Isr, Isr, Isr, Isr, Isr, Isr, Isr, Isr, Xoi, Xoi, Xoi, Xoi, Xoi, Xoi, Xoi
Xoi, Xoi, Xoi, Xoi, Xoi^Efs, Iwr, Iwr, Xoi, Xoi^Efs, Iwr, Xoi, Iwr, Xoi, Iwr, Iwr, Iwr, Xoi, Xoi, Isr, Isr, Isr, Isr, Xoi, Isr, Xoi, Xoi, Xoi, Xoi, Xoi, Xoi, Xoi, Xoi
Xoi, Xoi, Xoi, Xoi, Iwr, Iwr, Iwr, Iwr, Iwr, Xoi, Xoi, Xoi, Xoi, Iwr, Iwr, Iwr, Xoi, Xoi, Xoi, Isr, Xoi, Xoi, Xoi, Xoi, Xoi, Xoi, Xoi, Xoi, Yf, Xoi, Xoi, Xoi
Xoi, Xoi, Xoi, Xoi, Xoi, Iwr, Iwr, Iwr, Iwr, Iwr, Xoi, Xoi, Xoi, Xoi, Xoi, Xoi, Xoi, Xoi, Xoi, Xoi, Xoi^Efs, Xoi^Efs, Yf, Xoi, Xoi, Xoi, Xoi, Yf, Yf, Yf, Xoi, Xoi
Xoi, Xoi, Xoi, Xoi, Xoi, Xoi, Xoi, Iwr, Xoi, Xoi, Xoi, Xoi, Xoi, Iwr, Iwr, Iwr, Xoi, Xoi, Xoi, Xoi, Yf, Yf, Yf, Xoi, Xoi, Xoi, Yf, Yf, Yf, Yf, Xoi, Xoi
Xoi, Xoi, Xoi, Xoi, Xoi, Xoi, Xoi, Xoi, Xoi, Xoi, Xoi, Xoi, Xoi, Iwr, Iwr, Iwr, Xoi, Xoi, Yf, Yf, Yf, Yf, Yf, Xoi, Xoi, Xoi, Yf, Yf, Yf, Yf, Xoi, Xoi
Xoi, Xoi, Xoi, Xoi, Xoi, Xoi, Xoi, Xoi, Xoi, Xoi, Xoi, Xoi, Xoi, Iwr, Iwr, Iwr, Xoi, Yf, Yf, Yf, Yf, Yf, Yf, Xoi, Xoi, Xoi, Yf, Yf, Yf, Yf, Xoi, Xoi
Xoi, Xoi, Xoi, Xoi, Xoi, Xoi, Xoi, Xoi, Xoi^Efs, Xoi^Efs, Iwr, Xoi, Iwr, Iwr, Iwr, Iwr, Xoi, Yf, Yf, Yf, Yf, Yf, Yf, Xoi, Xoi, Xoi, Yf, Yf, Yf, Yf, Xoi, Xoi
Xoi, Xoi, Xoi, Xoi, Xoi, Xoi, Xoi^Efs, Xoi, Iwr, Iwr, Iwr, Iwr, Iwr, Iwr, Iwr, Iwr, Xoi, Xoi, Xoi, Yf, Yf, Yf, Yf, Xoi, Xoi, Xoi, Yf, Yf, Yf, Yf, Xoi, Xoi
Xoi, Xoi, Xoi, Xoi, Xoi, Xoi^Efs, Iwr, Iwr, Iwr, Iwr, Xoi, Xoi, Xoi, Iwr, Iwr, Iwr, Xoi, Xoi, Xoi, Xoi, Xoi, Xoi, Yf^Ii, Xoi, Xoi, Xoi, Xoi, Yf, Yf, Yf, Xoi, Xoi
Xoi, Xoi, Xoi^Efs, Xoi^Efs, Iwr, Iwr, Iwr, Iwr, Xoi, Xoi, Xoi, Xoi, Xoi, Iwr, Iwr, Iwr, Xoi, Xoi, Xoi, Xoi, Xoi, Xoi, Xoi, Yf^Ii, Xoi, Xoi, Xoi, Yf, Xoi, Xoi, Xoi, Xoi
Xoi, Xoi, Iwr, Iwr, Iwr^TabY, Iwr, Iwr, Xoi, Xoi, Xoi, Xoi, Xoi, Xoi, Iwc, Iwc, Iwc, Xoi, Xoi, Xoi, Xoi, Xoi, Xoi, Xoi, Xoi, Xoi, Xoi, Xoi, Xoi, Xoi, Xoi, Xoi, Xoi
Xoi, Iwr, Iwr^TabY, Iwr, Iwr, Iwr, Xoi, Xoi, Xoi, Xoi, Xoi, Xoi, Xoi, Iwc, Iwr, Iwc, Xoi, Xoi, Xoi, Xoi, Xoi, Xoi, Xoi, Xoi, Xoi, Xoi, Xoi, Xoi, Xoi, Xoi, Xoi, Xoi
Xoi, Iwr, Iwr, Iwr, Xoi, Xoi, Xoi^Efs, Xoi, Xoi, Xoi, Xoi, Xoi, Xoi^Efs, Iwr, Iwr, Iwr, Xoi^Efs, Xoi, Xoi, Xoi, Xoi, Xoi, Xoi, Xoi, Xoi, Xoi, Xot^Edb, Xot^Efs, Xot^Edb, Xos, Xos, Xoi
Xoi, Iwr, Iwr, Xoi, Xoi, Xoi^Efs, Iwr, Iwr, Iwr, Xoi, Xoi, Xoi^Efs, Iwr, Iwr, Iwr, Iwr, Iwr, Xoi^Efs, Xoi, Xoi, Xoi, Xoi, Xoi^Efs, Xoi, Xoi, Xot^Edb, Isa, Isa, Isa, Isa, Xot, Xoi
Xoi, Iwr, Iwr, Xoi, Xoi, Iwr, Iwr, Iwr, Iwr, Iwr, Iwr, Iwr, Iwr, Iwr, Xoi, Iwr, Iwr, Iwr, Iwr, Iwr, Xoi, Yf, Yf, Xoi^Efs, Xoi, Xot, Isa, Xot^Efs, Xot^Edb, Isa, Xot, Xoi
Xoi, Iwr, Iwr, Xoi, Xoi, Iwr, Iwr, Iwr, Iwr, Iwr, Iwr, Iwr, Iwr, Xoi, Xoi^Efs, Xoi, Iwr, Iwr, Iwr, Iwr, Xoi, Yf, Yf, Yf, Xoi, Xot, Xot^Edb, Isa, Isa, Xot^Edb, Xot, Xoi
Xoi, Iwr, Iwr, Xoi, Xoi, Iwr, Iwr, Iwr, Xoi, Iwr, Xoi, Iwr, Iwr, Iwr, Iwr, Iwr, Iwr, Xoi, Xoi, Iwr, Xoi, Yf, Yf, Yf, Xoi, Xot, Isa, Xot^Edb, Xot^Edb, Isa, Xot, Xoi
Xoi, Iwr, Iwr, Xoi, Xoi, Iwr, Iwr, Xoi, Xoi, Xoi, Xoi^Efs, Xoi, Xoi, Iwr, Iwr, Iwr, Xoi, Xoi, Xoi, Xoi, Xoi, Yf, Yf, Yf^Ii, Xoi, Xot, Isa^Efs, Isa, Isa, Isa, Xot, Xoi
Xoi, Iwr, Iwr, Xoi, Xoi, Iwr, Iwr, Xoi, Xoi, Xoi^Efs, Iwo, Xoi, Xoi, Iwr, Iwr, Iwr, Xoi, Xoi, Xoi, Xoi, Xoi, Yf, Yf, Yf^Ii, Xoi, Xot, Isa, Xot, Xot^Efs, Isa, Xot, Xoi
Xoi, Iwr, Iwr, Xoi, Xoi, Iwr, Xoi, Xoi, Xoi, Iwo, Iwo, Xoi, Xoi, Iwc, Iwc, Iwc, Xoi, Xoi, Xoi, Xoi, Xoi, Yf, Yf^Ii, Yf^Ii, Xoi, Xot, Xot, Isa, Isa, Xot^Edb, Xot^Edb, Xoi
Xoi, Iwr, Iwr, Xoi^Efs, Xoi^Efs, Xoi, Xoi, Xoi, Xoi, Iwo, Iwo, Xoi, Xoi, Iwc, Iwr, Iwc, Xoi, Xoi, Xoi, Xoi, Xoi, Yf^Ii, Xoi, Yf^Ii, Xoi, Xot, Isa, Xot, Xos^Efs, Isa, Xot, Xoi
Xoi, Ch, Ch, Ch, Iwr, Xoi, Iwr^TabY, Xoi^Efs, Iwo, Iwo, Iwo, Xoi, Xoi^Efs, Iwr, Iwr, Iwr, Xoi^Efs, Xoi, Xoi, Xoi, Xoi, Xoi, Xoi, Xoi, Xoi, Xot, Xot, Isa, Isa, Isa, Xot, Xoi
Xoi, Ch, 3 Kh, Ch, Xoi, Iwr, Iwr, Iwr, Xoi, Iwo, Iwo, Xoi^Efs, Iwr, Iwr, Iwr, Iwr, Iwr, Xoi^Efs, Xoi, Xoi, Xoi, Xoi, Xoi, Xoi, Xoi, Xoi, Xoi, Xot, Xot, Isa, Xot, Xoi
Xoi, Xoi, Xoi, Xoi, Xoi, Xoi, Xoi, Xoi, Xoi, Xoi, Xoi, Xoi, Iwr, Ch, Ch, Ch, Iwr, Xoi, Xoi, Xoi, Xoi, Xoi, Xoi, Xoi, Xoi, Xoi, Xoi, Xoi, Xoi, Xot, Xoi, Xoi
Xoi, Xoi, Xoi, Xoi, Xoi, Xoi, Xoi, Xoi, Xoi, Xoi, Xoi, Xoi, Iwr, Ch, 1 Kh, Ch, Iwr, Xoi, Xoi, Xoi, Xoi, Xoi, Xoi, Xoi, Xoi, Xoi, Xoi, Xoi, Xoi, Xoi, 4 Xoi, Xoi
Xoi, Xoi, Xoi, Xoi, Xoi, Xoi, Xoi, Xoi, Xoi, Xoi, Xoi, Xoi, Xoi, Iwr, Iwr, Iwr, Xoi, Xoi, Xoi, Xoi, Xoi, Xoi, Xoi, Xoi, Xoi, Xoi, Xoi, Xoi, Xoi, Xoi, Xoi, Xoi
Xoi, Xoi, Xoi, Xoi, Xoi, Xoi, Xoi, Xoi, Xoi, Xoi, Xoi, Xoi, Xoi, Iwr, Iwr^Qhh, Iwr, Xoi, Xoi, Xoi, Xoi, Xoi, Xoi, Xoi, Xoi, Xoi, Xoi, Xoi, Xoi, Xoi, Xoi, Xoi, Xoi
Xoi, Xoi, Xoi, Xoi, Xoi, Xoi, Xoi, Xoi, Xoi, Xoi, Xoi, Xoi, Xoi, Xoi, Iwr^Qhh, Xoi, Xoi, Xoi, Xoi, Xoi, Xoi, Xoi, Xoi, Xoi, Xoi, Xoi, Xoi, Xoi, Xoi, Xoi, Xoi, Xoi
