Xom, Xom, Xom, Xom, Xom, Xom, Xom, Xom, Xom, Xom, Xom, Xom, Xom, Xom, Xom, Xom, Xom, Xom, Xom, Xom, Xom, Xom, Xom, Xom, Xom, Xom, Xom, Xuc, Xuc, Xuc, Xuc, Xuc, Xuc, Xuc, Xuc, Xuc, Xuc, Xuc, Xuc, Xuc, Xuc, Xuc, Xuc, Xuc, Xuc, Xuc, Xuc, Xuc, Xuc, Xuc, Xuc, Xuc
Xom, Xom, Xom, Xom, Xom, Xom, Xom, Xom, Xom, Xom, Xom, Xom, Xom, Xom, Xom, Xom, Xom, Xom, Xom, Xom, Xom, Xom, Xom, Xom, Xom, Xom, Xom, Xuc, Xuc, Xuc, Xuc, Xuc, Xuc, Xuc, Xuc, Xuc, Xuc, Xuc, Xuc, Xuc, Xuc, Xuc, Xuc, Xuc, Xuc, Xuc, Xuc, Xuc, Xuc, Xuc, Xuc, Xuc
Xom, Xom, Xom, Xom, Xom, Xom, Xom, Xom, Xom, Xom, Xom, Xom, Xom, Xom, Xom, Xom, Xom, Xom, Xom, Xom, Xom, Xom, Xom, Xom, Xom, Xom, Xom, Xuc, Xuc, Xuc, Xuc, Xuc, Xuc, Xuc, Xuc, Xuc, Xuc, Xuc, Xuc, Xuc, Xuc, Xuc, Xuc, Xuc, Xuc, Xuc, Xuc, Xuc, Xuc, Xuc, Xuc, Xuc
Xom, Xom, Xom, Xom, Xom, Xom, Xom, Xom, Xom, Xom, Xom, Xom, Xom, Xom, Xom, Xom, Xom, Xom, Xom, Xom, Xom, Xom, Xom, Xom, Xom, Xom, Xuc, Xuc, Xuc, Xuc, Uu^Vu, Xuc, Xuc, Xuc, Xuc, Xuc, Uu, Uu, Uu, Xuc, Xuc, Xuc, Uu, Uu, Uu, Xuc, Uu, Xuc, Xuc, Xuc, Xuc, Xuc
Xom, Xom, Xom, Xom, Xom, Xom, Xom, Xom, Xom, Xom, Xom, Xom, Xom, Xom, Xom, Xom, Xom, Xom, Xom, Xom, Xom, Xom, Xom, Xom, Xuc, Xuc, Xuc, Xuc, Xuc, Xuc, Xuc, Uu, Uu, Xuc, Xuc, Re, Xuc, Uu, Xuc, Uu, Xuc, Xuc, Xuc, Xuc, Re, Uu, Uu, Xuc, Uh, Uh, Xuc, Xuc
Xom, Xom, Xom, Xom, Xom, Xom, Xom, Xom, Xom^Efs, Xom, Xom, Xom, Xom, Xom, Xom, Xom, Xom, Xom, Xom, Xom, Xom, Xom, Xuc, Xuc, Xuc, Xuc, Xuc, Xuc, Xuc, Xuc, Xuc, Uu, Xuc, Xuc, Uu, Uu, Uu, Xuc, Uh, Xuc, Xuc, Xuc, Xuc, Re, Xuc, Xuc, Uu, Uu, Xuc, Xuc, Xuc, Xuc
Xom, Xom, Xom, Xom, Xom, Xom, Xom^Efs, Xom, Uu, Xom^Efs, Xom, Xom, Xom, Xom, Xom, Xom, Xom, Xom, Xom, Xom, Xuc, Xuc, Xuc, Xuc, Xuc, Xuc, Xuc, Xuc, Xuc, Xuc, Xuc, Uu, Uh, Uh, Xuc, Xuc, Xuc, Uh, Xuc, Uu, Uu, Uu, Uh, Uu, Uu, Xuc, Xuc, Uu, Xuc, Xuc, Xuc, Xuc
Xom, Xom, Xom, Xom, Xom, Xom^Efs, Uu, Uu, Uu, Uu, Uu, Xom^Efs, Xom^Efs, Xom, Xom, Xom, Xom, Xom, Xom, Xuc, Xuc, Xuc, Xuc, Xuc, Xuc, Tb^Tf, Tb^Tf, Xuc, Xuc, Xuc, Uu, Xuc, Xuc, Uh, Xuc, Xuc, Xuc, Xuc, Rd, Uu, Xuc, Uu, Uh, Uh, Uh, Xuc, Rd, Uu, Uu, Xuc, Xuc, Xuc
Xom, Xom, Xom, Xom, Xom, Uu, Uu, Uu, Uu, Rd, Rd, Uu, Uu, Xom, Xom, Xom, Xom, Xom, Xuc, Xuc, Xuc, Xuc, Xuc, Xuc, Tb^Tf, Tb^Tf, Xuc, Xuc, Xuc, Xuc, Xuc, Uu, Xuc, Xuc, Uu, Xuc, Uu, Uu, Uu, Xuc, Uu, Uu, Uu, Xuc, Xuc, Xuc, Re, Rd, Xuc, Uu, Xuc, Xuc
Xom, Xom, Xom, Xom, Xom, Uu, Uu, Uu, Ce, Uu, Uu, Uu, Uu, Xom, Xom, Xom, Xom, Xom, Xuc, Xuc, Xuc, Xuc, Tb^Tf, Xuc, Uu, Xuc, Xuc, Xuc, Xuc, Xuc, Xuc, Rd, Rd, Uu, Xuc, Uu, Xuc, Uu, Xuc, Xuc, Rd, Rd, Xuc, Xuc, Uu, Xuc, Xuc, Rd, Uu, Xuc, Xuc, Xuc
Xom, Xom, Xom, Xom, Xom, Uu, Uu, Ce, 2 Ke, Ce, Uu, Uu, Uu, Uu, Xom, Xom, Xom, Xom, Xuc, Xuc, Xuc, Tb^Tf, Uu, Uu, Xuc, Xuc, Xuc, Xuc, Xuc, Xuc, Xuc, Uu, Xuc, Uh, Xuc, Xuc, Xuc, Uu, Uh, Uh, Uu, Xuc, Uu, Xuc, Uu, Xuc, Xuc, Uu, Xuc, Xuc, Xuc, Xuc
Xom, Xom, Xom, Xom, Xom, Uu, Uu, Ce, Ce, Ce, Uu, Uu, Uu, Uu, Xom, Xom, Xom, Xuc, Xuc, Xuc, Xuc, Uu, 5 Uu, Uu^Vu, Tb^Tf, Xuc, Xuc, Xuc, Uh, Uh, Xuc, Uu, Xuc, Uu, Xuc, Xuc, Uu, Uu, Xuc, Uh, Uu, Uu, Xuc, Uu, Uh, Uh, Xuc, Uu, Uh, Uh, Xuc, Xuc
Xom, Xom, Xom, Xom, Xom, Uu, Uu, Uu, Uu, Uu, Re, Uu, Uu, Uu, Xom, Xom, Xom, Xuc, Xuc, Xuc, Uu, Uu, Uu, Re, Re, Xuc, Xuc, Xuc, Uh, Xuc, Uu, Uu, Xuc, Xuc, Uu, Uu, Xuc, Xuc, Xuc, Xuc, Re, Xuc, Xuc, Xuc, Xuc, Uh, Xuc, Xuc, Xuc, Xuc, Xuc, Xuc
Xom, Xom, Xom, Xom, Xom, Uu, Re, Uu, Rd, Uu, Uu, Uu, Xom, Xom, Xom, Xom, Xuc, Xuc, Xuc, Uu^Vu, Rd, Uu, Uu^Vu, Uu, Uu, Xuc, Xuc, Xuc, Xuc, Uu, Xuc, Xuc, Xuc, Xuc, Re, Xuc, Xuc, Xuc, Uu, Xuc, Rd, Xuc, Xuc, Xuc, Xuc, Xuc, Xuc, Xuc, Xuc, Xuc, Xuc, Xuc
Xom, Xom, Xom, Xom, Xom, Uu, Re, Uu, Re, Uu, Xom, Xom, Xom, Xom, Xom, Xuc, Xuc, Xuc, Xuc, Uu, Rd, Uu, Xuc, Xuc, Uu, Uu, Xuc, Xuc, Xuc, Xuc, Xuc, Xuc, Xuc, Xuc, Re, Xuc, Uh, Xuc, Xuc, Uu, Uu, Uu, Uu, Xuc, Uu, Xuc, Xuc, Xuc, Xuc, Xuc, Xuc, Xuc
Xom, Xom, Xom, Xom, Xom, Uu, Uu, Uu, Uu, Rd, Rd^Pr/, Xom, Xom^Efs, Xom, Xom^Efs, Xuc, Xuc, Xuc, Xuc, Xuc, Rd, Xuc, Xuc, Xuc, Xuc, Xuc, Xuc, Xuc, Xuc, Xuc, Xuc, Uu, Uu, Uu, Xuc, Xuc, Uh, Uu, Xuc, Xuc, Xuc, Xuc, Xuc, Uu, Uu, Uu, Uu, Xuc, Xuc, Xuc, Xuc, Xuc
Xom, Xom, Xom, Xom, Xom, Xom, Xom, Uu, Xom, Xom, Xom, Re, Re, Uu, Uu, Xom^Efs, Xuc, Xuc, Uu, Re, Xuc, Xuc, Xuc, Xuc, Xuc, Xuc, Xuc, Xuc, Xuc, Xuc, Uh, Rd, Uu, Xuc, Uu, Uh, Xuc, Uu, Xuc, Xuc, Uu, Uu^Vu, Uu, Xuc, Xuc, Xuc, Xuc, Uu, Xuc, Xuc, Xuc, Xuc
Xom, Xom, Xom, Xom, Xom, Xom, Xom, Xom, Xom, Xom, Xom, Xom, Xom, Uu, Uu, Qxu, Qxu, Uu, Xuc, Xuc, Xuc, Xuc, Xos, Xos, Xos, Xuc, Xuc, Xuc, Xuc, Xuc, Uh, Xuc, Xuc, Uu, Xuc, Xuc, Xuc, Uu, Xuc, Xuc, Xuc, Xuc, Re, Xuc, Xuc, Xuc, Xuc, Xuc, Xuc, Xuc, Xuc, Xuc
Xom, Xom, Xom, Xom, Xom, Xom, Xom, Xom, Xom, Xom, Xom, Xom, Xom, Uu, Re, Qxu^Bp/, Qxu, Xuc, Xuc, Xuc, Xuc, Xos, Xos, Xos, Xos, Xos, Xuc, Xuc, Uu, Uh, Xuc, Xuc, Xuc, Xuc, Xuc, Xuc, Xuc, Uu, Uh, Uh, Uu, Xuc, Uu, Uu, Xuc, Xuc, Xuc, Xuc, Xuc, Xuc, Xuc, Xuc
Xom, Xom, Xom, Xom, Xom, Xom, Xom, Xom, Xom, Xom, Xu, Xom, Xom, Uu, Uu, Uu, Xom, Xuc, Xuc, Xuc, Xos, Xos, Xos, Xos, Uu, Uu, Uu^Br/, Uu, Re, Xuc, Xuc, Xuc, Xuc, Xuc, Xuc, Xuc, Xuc, Xuc, Xuc, Xuc, Xuc, Uu, Xuc, Uu, Xuc, Xuc, Xuc, Xuc, Xuc, Xuc, Xuc, Xuc
Xom, Xom, Xom, Xom, Xom, Xom, Xom, Xom, Xu, Xu, Xu, Xu, Xom, Re, Uu, Xom, Xom, Xuc, Xos, Xos, Xos, Xos, Uu, Uu, Rd^Br/, Uu^Br/, Rd, Uu, Uu, Ur, Uu^Pr/, Xuc, Xuc, Xuc, Xuc, Xuc, Xuc, Xuc, Uh, Xuc, Xuc, Xuc, Xuc, Xuc, Xuc, Xuc, Xuc, Xuc, Xuc, Xuc, Xuc, Xuc
Xom, Xom, Xom, Xom, Xom, Xom, Xom, Xu, Xom, Xu, Xu, Xu, Rd, Re, Uu, Xom, Xom, Xos, Xos, Xos, Uu, Uu, Uu^Br/, Rd^Br/, Xos, Xos, Uu, Uu, Xos, Xuc, Xuc, Ur, Re, Xuc, Uu, Xuc, Xuc, Uu, Uu, Xuc, Xuc, Xuc, Xuc, Xuc, Xuc, Xuc, Xuc, Xuc, Xuc, Xuc, Xuc, Xuc
Uu^Ii, Uu, Uu, Xom^Efs, Uu^Vud, Xom^Efs, Uu, Xom^Efs, Uu, Xu, Re, Uu, Uu, Uu, Uu, Xom, Xom, Xos, Uu, Re, Re^Br/, Uu^Br/, Xos, Uu, Re, Re, Xos, Xos, Xuc, Xuc, Xuc, Xuc, Xuc, Re, Xuc, Xuc, Xuc, Xuc, Uu, Xuc, Uu, Xuc, Uu, Xuc, Re, Xuc, Uu, Xuc, Xuc, Xuc, Xuc, Xuc
Uu^Ii, Ce, 1 Ke, Uu, Ce, Uu, Uu, Uu, Rd, Uu, Uu, Rd, Uu, Qxu, Uu, Uu, Uu, Uu, Uu^Br/, Uu^Br/, Xos, Xos, Xos, Xos, Xos, Xos, Xos, Xos, Xuc, Xuc, Xuc, Xuc, Xuc, Uh, Uh, Uu, Uu, Uu, Xuc, Rd, Xuc, Xuc, Uh, Uu, Xuc, Re, Xuc, Uu, Xuc, Xuc, Xuc, Xuc
Uu^Ii, Ce, Ce, Ce, Ce, Re, Uu, Rd, Uu, Uu, Uu, Uu, Re, Qxu, Uu, Re, Uu^Br/, Uu^Br/, Xos, Xos, Xos, Xos, Xos, Xos, Xos, Xos, Xos, Xos, Xuc, Xuc, Xuc, Xuc, Xuc, Uu, Uu, Xuc, Xuc, Uu, Re, Xuc, Xuc, Uu, Xuc, Xuc, Xuc, Xuc, Xuc, Xuc, Xuc, Xuc, Xuc, Xuc
Xom, Uu, Xom, Uu, Xom, Xom, Xom, Xom, Xom, Xom, Xom, Uu, Uu, Uu, Uu^Br/, Uu^Br/, Uu, Rd, Uu, Uu, Rd, Xos, Xos, Xos, Xos, Xos, Xos, Xos, Xos, Xuc, Xuc, Xuc, Xuc, Xuc, Xuc, Xuc, Xuc, Uu, Xuc, Uu, Uu, Uu, Xuc, Xuc, Xuc, Xuc, Xuc, Xuc, Uh, Uh, Xuc, Xuc
Xom, Xom, Xom, Xom, Xom, Xom, Xom, Xom, Xom^Efs, Xom^Efs, Uu, Uu, Uu^Br/, Uu^Br/, Xos^Efs, Xos, Xos, Xos, Xos, Xos, Xos, Rd, Uu, Xos, Xos, Xos, Xos^Efs, Xos, Xos, Xos, Xos, Xuc, Xuc, Xuc, Xuc, Xuc, Xuc, Uh, Xuc, Xuc, Rd, Xuc, Uu, Rd, Uu, Uh, Uu, Uu, Xuc, Uu, Xuc, Xuc
Xom, Xom, Xom, Xom, Xom, Xom, Xom^Efs, Xom, Uu, Uu, Uu^Br/, Uu^Br/, Xos^Efs, Xos^Efs, Rd, Rd, Rd, Rd, Xos, Xos, Uu, Uu, Uu, Uu, Uu, Rd, Uu, Xos^Efs, Xos, Xos, Xos, Xos, Xuc, Xuc, Xuc, Xuc, Uu, Uh, Xuc, Xuc, Rd, Uu, Uu, Xuc, Xuc, Uu, Xuc, Uu, Xuc, Xuc, Xuc, Xuc
Xom, Xom, Xom, Xom, Xom, Xom^Efs, Uu, Uu, Uu^Br/, Uu^Br/, Xos, Xos, Rd, Rd, Rd, Rd, Rd, Rd, Xos, Uu, Ce, Ce, Ce, Xos, Xos, Rd, Uu, Uu, Uu, Xos, Xos, Xos, Xos, Xuc, Xuc, Xuc, Uu, Xuc, Xuc, Xuc, Uu, Xuc, Xuc, Uu, Uu, Xuc, Xuc, Uu, Uu, Xuc, Xuc, Xuc
Xom, Xom, Xom^Efs, Uu^Vud, Uu, Uu, Uu^Br/, Uu^Br/, Xos, Xos, Xos, Xos, Xos, Rd, Xos, Xos, Xos, Rd, Rd, Xos, Uu^Pr\, 3 Ke, Xos, Xos, Xos, Xos, Xos, Xos, Uu, Xos, Xos, Xos, Xos, Xuc, Xuc, Xuc, Xuc, Xuc, Xuc, Xuc, Uh, Uh, Xuc, Xuc, Xuc, Xuc, Xuc, Xuc, Uu, Xuc, Xuc, Xuc
Xom, Xom^Efs, Uu, Uu, Uu^Br/, Uu^Br/, Xos, Xos, Xos, Xos, Re^Vd, Re, Re, Xos, Re^Vd, Re, Re, Xos, Rd, Rd, Rd, Xos, Re, Re, Re, Xos, Xos, Xos, Uu, Uu, Xos, Xos, Xos, Xos, Xos, Xuc, Xuc, Xuc, Xuc, Xuc, Xuc, Xuc, Xuc, Xuc, Xuc, Xuc, Xuc, Uu, Xuc, Xuc, Xuc, Xuc
Uu^Ii, Uu^Pr\, Uu^Pr\, Uu^Br/, Xos, Xos, Xos, Xos, Xos, Xos, Re, Re, Re, Xos, Re, Re, Re, Xos, Xos, Rd, Xos, Xos, Re, Re, Re, Xos, Xos, Uu, Xos, Re, Xos, Xos, Xos, Xos, Xos, Xuc, Xuc, Xuc, Xuc, Xuc, Xuc, Xuc, Xuc, Xuc, Xuc, Xuc, Xuc, Xuc, Xuc, Xuc, Xuc, Xuc
Uu^Br/, Uu^Br/, Xos, Xos, Xos, Xos, Xos, Xos, Xos, Xos, Xos, Re, Uu, Xos, Uu, Re, Uu, Xos, Uu, Xos, Uu, Xos, Uu, Re, Uu, Xos, Qxu, Xos, Xos, Uu, Xos, Xos, Xos, Xos, Xos, Xuc, Xuc, Xuc, Xuc, Xuc, Xuc, Xuc, Xuc, Xuc, Xuc, Xuc, Xuc, Xuc, Xuc, Xuc, Xuc, Xuc
Xos, Xos, Xos, Xos, Xos, Xos, Xos, Xos, Xos, Xos, Xos, Xos, Xos, Uu, Xos, Xos, Xos, Uu, Uu, Uu, Uu, Uu, Xos, Xos, Xos, Uu, Qxu, Uu^Vu, Uu, Uu, Xos, Xos, Xos, Xos, Xos, Xos, Xos, Xuc, Xos, Xuc, Xos, Xuc, Xuc, Xuc, Xuc, Xuc, Xuc, Xuc, Xos, Xos, Xos, Xos
Xos, Xos, Xos, Xos, Xos, Xos, Xos, Xos, Xos, Xos, Xos, Xos, Uu, Uu, Uu, Xos, Uu, Uu, Uu, Uu, Uu, Uu, Uu, Xos, Uu, Uu, Uu, Uu, Xos, Xos, Xos, Xos, Xos, Xos, Xos, Xos, Xos, Xos, Xos, Xos, Xos, Xos, Xos, Xuc, Xuc, Xuc, Xos, Xos, Xos, Xos, Xos, Xos
Xos, Xos, Xos, Xos, Xos, Xos, Xos, Xos, Xos, Xos, Re, Re, Re, Xos, Re, Re, Re, Xos, Xos, Xos, Xos, Xos, Re, Re, Re, Xos, Xos, Xos, Xos, Xos, Xos, Xos, Xos, Xos, Xos, Xos, Xos, Xos, Xos, Xos, Xos, Xos, Xos, Xos, Xos, Xos, Xos, Xos, Xos, Xos, Xos, Xos
Xos, Xos, Xos, Xos, Xos, Xos, Xos, Xos, Xos, Xos, Re^Vd, Re, Re, Xos, Re^Vd, Re, Re, Xos, Xos, Xos, Xos, Xos, Re, Re, Re, Xos, Xos, Xos, Xos, Xos, Xos, Xos, Xos, Xos, Xos, Xos, Xos, Xos, Xos, Xos, Xos, Xos, Xos, Xos, Xos, Xos, Xos, Xos, Xos, Xos, Xos, Xos
Xos, Xos, Xos, Xos, Xos, Xos, Xos, Xos, Xos, Xos, Xos, Re, Xos, Xos, Xos, Re, Xos, Xos, Xos, Xos, Xos, Xos, Xos, Re, Xos, Xos, Xos, Xos, Xos, Xos, Xos, Xos, Xos, Xos, Xos, Xos, Xos, Xos, Xos, Xos, Xos, Xos, Xos, Xos, Xos, Xos, Xos, Xos, Xos, Xos, Xos, Xos
Xos, Xos, Xos, Xos, Xos, Xos, Xos, Xos, Xos, Xos, Xos, Xos, Xos, Xos, Xos, Xos, Xos, Xos, Xos, Xos, Xos, Xos, Xos, Xos, Xos, Xos, Xos, Xos, Xos, Xos, Xos, Xos, Xos, Xos, Xos, Xos, Xos, Xos, Xos, Xos, Xos, Xos, Xos, Xos, Xos, Xos, Xos, Xos, Xos, Xos, Xos, Xos
Xos, Xos, Xos, Xos, Xos, Xos, Xos, Xos, Xos, Xos, Xos, Xos, Xos, Xos, Xos, Xos, Xos, Xos, Xos, Xos, Xos, Xos, Xos, Xos, Xos, Xos, Xos, Xos, Xos, Xos, Xos, Xos, Xos, Xos, Xos, Xos, Xos, Xos, Xos, Xos, Xos, Xos, Xos, Xos, Xos, Xos, Xos, Xos, Xos, Xos, Xos, Xos
Xos, Xos, Xos, Xos, Xos, Xos, Xos, Xos, Xos, Xos, Xos, Xos, Xos, Xos, Xos, Xos, Xos, Xos, Xos, Xos, Xos, Xos, Xos, Xos, Xos, Xos, Xos, Xos, Xos, Xos, Xos, Xos, Xos, Xos, Xos, Xos, Xos, Xos, Xos, Xos, Xos, Xos, Xos, Xos, Xos, Xos, Xos, Xos, Xos, Xos, Xos, Xos
Xos, Xos, Xos, Xos, Xos, Xos, Xos, Xos, Xos, Xos, Xos, Xos, Xos, Xos, Xos, Xos, Xos, Xos, Xos, Xos, Xos, Xos, Xos, Xos, Xos, Xos, Xos, Xos, Xos, Xos, Xos, Xos, Xos, Xos, Xos, Xos, Xos, Xos, Xos, Xos, Xos, Xos, Xos, Xos, Xos, Xos, Xos, Xos, Xos, Xos, Xos, Xos
