border_size=1
usage=map

Hh, Hh, Hh, Hh, Rr, Gg, Gg, Gg, Gg, Xu, Uu, Uu, Uu, Xu, Gs^Fp, Ww, Ww, Ww, Ww, Ww, Gg, Gg
Hh, Hh, Hh, Hh, Rr, Gg, Gg, Gg, Gg, Xu, Uu, Uu, Uu, Xu, Gg, Gg, Gg^Em, Ww, Gg^Vh, Ww, Gg, Gg
Gg, Gg, Gg, Gg, Rr, Aa, Gg, Gg, Gg^Vh, Xu, Uu, Uu, Uu, Xu, Gg, Gg, Gg, Gg, Gg, Ww, Gg, Gg
Gg, Gg, Gg, Gg, Gg, Rr, Rr, Gg, Gg, Xu, Gg, Uu, Gg, Xu, Gg, Gg, Gg, Aa, Ww, Ww, Gg, Gs^Fp
Gs^Fp, Gs^Fp, Gs^Fp, Ce, Ce, Ce, Gg, Rr, Gg, Gg, Gs^Fp, Gg, Gg, Gg, Gs^Fp, Gs^Fp, Gg, Gg, Ww, Gg, Gg, Hh
Gs^Fp, Gs^Fp, Gs^Fp, Ce, 1 Ke, Ce, Gg, Rr, Rr, Gg, Gs^Fp, Gs^Fp, Gs^Fp, Gs^Fp, Gg, Gg, Gs^Fp, Ww, Gg, Gs^Fp, Gg, Hh
Gs^Fp, Gs^Fp, Gs^Fp, Gs^Fp, Gs^Fp, Rr, Gg, Gg, Rr, Gg, Gs^Fp, Gg, Gg, Gg, Gg^Es, Gg, Gg, Ww, Gs^Fp, Gs^Fp, Gg, Hh
Gg, Gs^Fp, Gs^Fp, Gs^Fp, Gs^Fp, Rr, Gs^Fp, Gg, Gg, Rr, Rr, Gg, Rr, Gg, Gg, Gg, Ww, Ww, Gg, Gs^Fp, Gg, Hh
Gg, Gg, Gg, Gs^Fp, Rr, Rr, Gg^Ve, Gs^Fp, Gg, Gg, Gs^Fp, Rr, Gg^Em, Rr, Rr, Gg, Ww, Gg, Gg, Gg, Gs^Fp, Gg
Gg, Gg, Rr, Rr, Gg, Gs^Fp, Gs^Fp, Gs^Fp, Gg, Gg, Hh, Hh, Ww, Ww, Ww, Ww^Bw\, Rr, Rr, Rr, Rr, Rr, Gs^Fp
Gg, Rr, Gg, Gs^Fp, Gs^Fp, Gs^Fp, Gs^Fp, Gg, Hh, Hh, Hh, Hh, Ww, Mm, Mm, Mm, Mm, Hh^Vhh, Hh, Hh, Rr, Gs^Fp
Gg, Rr, Gg, Gg, Gg, Gg, Gg, Hh, Hh, Hh, Mm, Mm^Vhh, Ww, Mm, Mm, Mm, Mm, Mm, Mm, Hh, Rr, Gg
Rr, Rr, Gg, Gg, Gg, Gg, Hh, Hh, Hh, Mm, Mm, Ww, Mm, Mm, Mm, Mm, Mm, Mm, Mm, Hh, Gg, Rr
Gg, Gg, Gg, Gg, Gg^Vh, Hh, Mm, Mm, Mm, Mm, Mm, Ai, Mm, Mm, Mm, Mm, Mm, Mm, Mm, Mm, Hh, Gs^Fp
Gg, Gg, Aa, Ha, Ha, Mm, Mm, Mm, Mm, Mm, Mm, Ww, Ww, Mm, Mm, Mm, Mm, Mm, Mm, Mm, Hh, Hh
Aa, Aa, Aa, Ha, Ha, Mm, Mm, Mm, Mm, Mm, Ai, Ww, Ww, Mm, Mm, Mm, Mm, Mm, Mm, Mm, Hh, Hh
Aa, Aa, Aa, Ha, Ha, Mm, Mm, Mm, Mm, Mm, Ww, Ww, Ww, Mm, Mm, Mm, Mm, Mm, Mm, Mm, Hh, Rr
Rr, Gg, Aa, Ha, Hh, Mm, Mm, Mm, Mm, Ww, Ww^Vm, Ww, Ww, Mm, Mm, Mm, Mm, Mm, Mm, Mm, Mm, Rr
Rr, Gg, Gg, Ha, Mm, Mm, Mm, Mm, Ww, Ww, Ww, Ww, Ww, Mm, Mm, Mm, Mm, Mm, Mm^Vhh, Hh, Hh, Rr
Rr, Gg, Gg, Ha, Hh, Mm, Mm, Mm, Mm, Ww, Ww, Ww, Mm, Mm, Mm, Mm, Mm, Mm, Hh, Hh, Hh, Rr
Gg, Rr, Rr, Aa, Hh, Hh, Mm, Mm, Mm, Mm, Mm, Mm, Mm, Mm, Mm, Mm, Mm, Hh, Hh, Gg, Gg, Rr
Rr, Gg, Rr, Aa, Gg, Hh, Mm, Mm, Mm, Mm, Mm, Mm, Mm, Mm, Mm, Hh, Hh, Aa, Gg, Gg, Gg, Rr
Gs^Fp, Rr, Gg, Aa, Rr, Hh, Hh, Hh, Hh, Mm, Hh, Hh, Hh, Hh, Gg, Gg, Gg^Vh, Gg, Gg, Aa, Aa, Aa
Gg, Rr, Gg, Gg, Gg, Rr, Rr, Gs^Fp, Gs^Fp, Hh, Gg, Gg, Gg, Aa, Aa, Gg, Gg, Gg, Aa, Aa, Aa, Aa
Gg, Rr, Rr, Gg, Rr, Gg, Gg, Rr, Rr, Gs^Fp, Gg, Gg, Gg, Gg, Aa, Gg, Gg, Gg, Gg, Gg, Gg, Gg
Gg, Gg, Gg, Rr, Gg^Vh, Rr, Gg, Gg, Gs^Fp, Rr, Rr, Gg, Gg^Em, Gg, Gg, Gg, Gg, Gg^Es, Gg, Gg, Gg, Gg
Gg, Gg, Gg^Es, Gg, Gg, Rr, Rr, Gg, Gs^Fp, Gs^Fp, Gg^Vh, Rr, Gg, Gg, Aa, Gg, Gg, Gg, Gg, Gs^Fp, Gs^Fp, Gg
Gg, Gg, Gg, Gg, Ww, Gg, Gg, Rr, Rr, Gg, Gg, Rr, Gg, Aa, Gg, Gg, Gg, Gg, Gs^Fp, Gs^Fp, Gs^Fp, Gs^Fp
Gg, Aa, Aa, Ai, Aa, Ww, Ww, Ww, Ww, Rr, Gg, Rr, Aa, Aa, Gg, Gg, Gg, Gg, Gg^Ve, Gs^Fp, Gs^Fp, Gs^Fp
Ww, Ai, Ai, Ai, Aa, Gg, Gg, Ww, Ww, Rr, Gg^Es, Rr, Aa, Aa, Gg, Gg, Gg, Gs^Fp, Gs^Fp, Gs^Fp, Gs^Fp, Gg
Hh, Ha, Ha, Aa, Ha, Hh, Gg, Gg, Ww, Rr, Rr, Rr, Rr, Gg, Rr, Ce, Ce, Ce, Gs^Fp, Gg, Gg, Gg
Ha, Ha, Ha, Ha, Ha, Hh, Gg, Gg, Gg, Ww, Gg, Rr, Gg^Vh, Rr, Ww, Ce, 2 Ke, Ce, Gg, Hh, Hh, Hh
Hh, Hh, Hh, Hh, Hh, Hh, Gg^Ve, Gs^Fp, Gs^Fp, Ww, Gs^Fp, Rr, Ww, Ww, Ww, Gs^Fp, Gg, Gg, Hh, Hh, Hh, Hh
Hh, Hh, Hh, Hh, Hh, Hh, Gs^Fp, Gs^Fp, Gs^Fp, Ww, Ww, Chr, Rr, Rr, Ww^Bw\, Gg, Gg, Gg, Hh, Hh, Hh, Rr
Hh, Hh, Mm, Hh, Hh, Hh, Hh, Gs^Fp, Gs^Fp, Gs^Fp, Gs^Fp, Gg, Gg, Gg, Ww, Rr, Rr, Gs^Fp, Hh, Hh, Hh, Rr
Mm, Mm, Mm, Mm, Hh, Hh, Hh, Gs^Fp, Gs^Fp, Gs^Fp, Gs^Fp, Gg, Gg, Gg, Ww, Ww, Rr, Hh, Hh, Hh, Hh, Hh
Mm, Mm, Mm, Mm, Mm, Mm, Hh, Gs^Fp, Gs^Fp, Gs^Fp, Gg, Gg, Gg, Gg, Gg, Ww, Ww, Rr, Rr, Hh, Hh, Hh
