Md, Md, Md, Md, Md, Md, Md, Md, Md, Md, Md, Md, Md, Md, Md, Md, Md, Md, Md, Md, Md, Md, Md, Md, Md, Md, Md, Md, Md, Hhd, Re, Rd, Re, Re, Re, Re, Rd, Re, Re, Rd, Rd, Rd, Re, Re, Rd, Rd, Rd
Md, Md, Md, Md, Md, Md, Md^Xm, Md, Md, Md, Md, Md, Md^Xm, Md, Md^Xm, Md, Md, Md, Md, Md, Md, Md, Md, Md, Md, Md, Md, Md, Md, Hhd, Re, Re, Rd, Re, Re, Rd, Rd, Re, Re, Re, Re, Re, Re, Re, Re, Re, Rd
Md, Md, Md, Md, Md^Xm, Md^Xm, Md, Md^Xm, Md, Md, Md, Md^Xm, Md, Md^Xm, Md, Md, Md, Md, Md, Md, Md, Md, Md, Md, Md, Md, Md, Md, Md, Hhd, Re, Rd, Rd, Re, Re, Re, Rd, Rd, Rd, Re, Re, Re, Ur, Ur, Ur, Re, Re
Md, Md, Md, Md^Xm, Md^Xm, Md, Hhd, Md, Hhd, Md, Hhd, Hhd, Md, Md, Md, Md, Hhd, Md, Md, Md, Md, Md, Md, Md, Md, Md, Md, Md, Hhd, Hhd, Re, Rd, Re, Re^Vct, Re, Re, Rd, Rd, Re, Re, Re, Ur, Uu^Qhu, Uu^Qhu, Uu^Qhu, Ur, Re
Md, Md, Md, Md, Md^Xm, Md, Hhd, Hhd, Gd, Hhd, Gd, Hhd, Hhd, Hhd, Hhd, Hhd, Gd^Fmw, Hhd, Hhd, Md, Hhd, Md, Md, Hhd, Hhd, Md, Hhd, Md, Hhd, Re, Re, Re, Re, Re, Re, Rd, Re, Re, Re, Re, Re, Ur, Uu^Qhu, Yl, Uu^Qhu, Ur, Re
Md, Md^Xm, Md^Xm, Md, Md, Md, Hhd, Gd, Re, Gd, Gd, Gd, Gd, Hhd, Hhd, Gd^Fmw, Gd^Fmw, Gd, Gd, Hhd, Gd, Hhd, Md, Hhd, Dd, Hhd, Dd, Hhd, Hhd, Re, Re, Rd, Re, Rd, Rd, Rd, Re, Re, Re, Re, Rd, 3 Ur, Ur, Uu^Qhu, Ur, Ur, Re
Md, Md, Md, Md, Hhd, Hhd, Re, Re, Gd, Re, Re, Re, Re, Gd, Gd, Gd^Fmw, Gd, Gd, Gd, Hhd, Gd, Hhd, Hhd, Hhd, Dd, Dd, Dd, Dd, Hhd, Hhd, Re, Rd, Re, Rd, Re, Rd, Re, Re, Co, Rd, Rd, Rd, Re, Ur, Re, Re, Re
Md, Md, Md, Hhd, Hhd, Gd, Re, Gd, Re, Re, Gd, Re, Gd, Gd, Gd, Gd, Rd, Gd, Gd, Gd, Gd^Fmw, Gd, Gd, Gd, Gd, Dd, Dd, Dd, Re, Re, Rd, Rd, Re, Re, Re, Re, Re, Co, 2 Ko, Co, Rd, Rd, Re, Re, Re, Re, Rd
Md, Md, Hhd, Hhd, Gd, Gd, Re, Re, Re, Re, Re, Gd^Fmw, Gd^Fmw, Gd, Gd, Rd, Gd, Gd, Gd, Gd, Gd, Gd^Fmw, Gd, Re, Re, Gd, Gd, Dd, Dd, Re, Re, Re, Rd, Re, Re, Re, Re, Co, Co, Co, Rd, Rd, Re, Re, Rd, Rd, Re
Hhd, Hhd, Gd, Gd, Re, Re, Re, Re, Re, Gd, Re, Gd, Gd, Gd, Rd, Gd, Gd, Gd, Gd, Re, Re, Gd, Gd, Re, Re, Rd, Gd, Dd, Dd, Re, Re, Re, Rd, Rd, Re, Re, Re, Re, Rd, Rd, Rd, Rd, Re, Rd, Re, Re, Re
Ww, Gd, Re, Re, Gd, Re, Gd, Gd, Re, Re, Re, Re, Gd, Gd, Re, Gd, Gd, Gd, Re, Re, Re, Re, Gd, Re, Re, Rd, Gd, Dd, Dd, Dd, Re, Re, Rd, Re, Rd, Re, Re, Re, Re, Rd, Re, Re, Re, Rd, Rd, Re, Re
Dd, Ww, Ww, Gd, Rd, Gd, Gd, Re, Re, Re, Re, Re, Gd, Gd, Re, Re, Re, Re, Re, Gd, Re, Re, Gd, Re, Re, Gd, Gg^Ve, Dd, Dd, Dd, Re, Re, Rd, Re, Re, Rd, Re, Re, Re, Rd, Rd, Re, Re, Re, Re, Re, Re
Dd, Dd, Dd, Ww, Ww, Rd, Re, Re, Re, Re, Re, Re, Gd, Re, Re, Re, Gd, Re, Gd, Re, Re, Gd, Gd, Gd, Gd, Re, Gd, Gd, Gd^Fmw, Dd, Dd, Re, Re, Rd, Re, Rd, Re, Re, Re, Rd, Re, Rd, Rd, Re, Re, Re, Re
Dd, Dd, Dd, Dd, Ww, Ww, Re, Re, Re, Re, Gd, Gd, Gd, Gd, Gd, Gd, Gd, Re, Gd, Re, Rb^Yc, Rb^Yc, Gd, Gd, Re, Gd, Gd, Gd, Gd^Fmw, Dd, Dd, Re, Re, Re, Re, Rd, Re, Re, Re, Re, Re, Re, Re, Rd, Re, Re, Rd
Dd, Dd, Dd, Dd, Ww, Ww, Re, Re, Rd, Rd, Gd, Gd, Gd, Gg^Ve, Gd, Gd, Gd^Fmw, Gd, Gd, Gd, Gd, Gd, Re, Re, Re, Gd, Hhd, Hhd, Hhd, Gd, Gd, Dd, Dd, Re, Re, Re, Rd, Re, Re, Re, Re, Re, Re, Re, Re, Re, Rd
Dd, Dd, Dd, Dd, Ww, Ww, Gd, Gd, Gd, Gd, Gd, Gd, Gd, Gd, Gd, Gd^Fmw, Gd^Fmw, Gd, Gd^Yc, Gd^Yc, Gd, Gd, Re, Gd, Re, Gd, Hhd, Md, Hhd, Hhd, Gd, Dd, Dd, Re, Re, Rd, Re, Re, Re, Re^Vct, Re, Re, Re, Re, Re, Rd, Re
Dd, Dd, Dd, Dd, Ww, Gd^Fmw, Gd, Rd, Gd, Gd, Gd, Re, Re, Re, Gd, Gd^Fmw, Gd, Gd, Gd^Yc, Gd, Gd, Gd, Gd, Re, Gd, Gd, Hhd, Md, Hhd, Gd, Gd, Dd, Dd, Dd, Dd, Rd, Re, Re, Rd, Rd, Re, Re, Rd, Re, Re, Re, Re
Dd, Dd, Dd, Dd, Ww, Gd^Fmw, Rd, Gd, Re, Re, Re, Gd, Gd, Gd, Gd, Gd, Gd^Yc, Gd^Yc, Gd, Gd, Gd, Gd, Rd, Gd, Rd, Gd, Gd, Hhd, Gd, Gd, Dd, Dd, Dd, Dd, Dd, Re, Re, Re, Re, Re, Re, Re, Re, Rd, Re, Re, Re
Dd, Dd, Dd, Ww, Ww, Gd, Re, Gd, Re, Gd, Gd, Gd, Gd, Gd, Gd^Yc, Gd^Yc, Gd, Gd, Re, Gd, Gd, Gd, Gd, Rd, Gd, Gd, Gd, Gd, Dd, Dd, Dd, Dd, Dd, Dd, Dd, Dd, Dd, Re, Rd, Rd, Re, Re, Re, Rd, Rd, Re, Re
Dd, Dd, Ww, Ww, Re, Re, Gd, Re, Gd, Gd, Gd, Gd^Fmw, Gd, Gd^Yc, Gd, Gd, Gd, Re, Re, Re, Gd, Gd, Dd, Gd, Dd, Dd, Dd, Dd, Dd, Dd, Dd, Dd, Dd, Dd, Dd, Rd, Rd, Dd, Dd, Re, Dd, Re, Re, Re, Re, Re, Re
Dd, Dd, Ww, Gg, Gd, Gd, Gd, Gd, Re, Re, Gd, Gd, Gd, Gd, Gd, Gd, Re, Re, Gd, Gd, Dd, Dd, Dd, Dd, Dd, Dd, Dd, Dd, Dd, Dd, Dd, Dd, Dd, Dd, Dd, Dd, Rd, Dd, Hd, Dd, Dd, Dd, Dd, Re, Re, Re, Re
Dd, Dd, Ww, Gd, Gd, Gd, Gd, Re, Re, Gd, Re, Re, Re, Gd, Gd, Gd, Gd, Gd, Dd, Dd, Dd, Dd, Dd, Dd, Dd, Dd, Dd, Dd, Dd^Dc, Rd, Dd, Dd, Dd, Dd, Ds, Dd, Dd, Rd, Hd, Hd, Dd, Dd, Dd, Dd, Re, Re, Re
Dd, Dd, Ww, Gg, Rd, Gd, Re, Re, Gd, Re, Gd, Re, Gd, Gd, Gd, Gd, Gd^Fmw, Gd, Dd, Dd, Dd, Dd, Dd, Dd, Rd, Rd, Dd, Dd, Dd, Dd, Dd, Dd, Dd, Ds, Dd, Dd, Dd, Rd, Dd, Hd, Dd, Dd, Dd, Dd, Dd, Dd, Dd
Dd, Dd, Ww, Rd, Gd, Gd, Re, Re, Gd, Gd, Gd, Gd, Gd, Gd, Gd, Gd^Fmw, Gd^Fmw, Dd, Dd, Dd, Rd, Dd, Dd, Dd, Ds, Dd, Dd, Dd, Dd, Rd, Dd, Ds, Ds, Ds, Dd, Dd, Dd, Dd, Rd, Dd, Dd, Dd, Rd, Dd, Dd, Dd, Dd
Dd, Dd, Ww, Gd, Gd, Gd, Re, Re, Gd, Gg^Ve, Gd, Ce, Ce, Ce, Gd, Gd^Fmw, Dd, Dd, Dd, Dd, Dd, Rd, Dd, Dd, Dd, Ds, Dd, Dd, Dd, Rd, Dd, Dd, Dd, Dd, Dd, Dd, Dd, Rd, Dd, Dd, Dd, Dd, Rd, Dd, Dd, Dd, Dd
Ww, Ww, Rd, Rd, Gd, Gd, Re, Re, Re, Gd, Gd, Ce, 1 Ke, Ce, Gd, Gd, Dd, Dd, Dd, Dd, Dd, Dd, Dd, Rd, Dd, Rd, Dd, Dd, Dd, Dd, Dd, Dd, Dd, Ql, Dd, Dd, Dd, Rd, Dd, Dd, Dd, Rd, Dd, Dd, Ds, Ds, Dd
Ww, Gd, Gd, Gd, Re, Re, Re, Re, Re, Gd, Gd, Gd, Ce, Gd, Gd, Dd, Dd, Dd, Dd, Dd, Hd, Hd, Dd, Rd, Dd, Dd, Hd, Hd, Dd, Dd, Dd, Dd, Ql, Ql, Dd, Dd, Dd, Rd, Dd, Dd, Dd, Rd, Dd, Ds, Dd, Dd, Dd
Gd^Fmw, Gd, Gd, Gd, Gd, Re, Gd, Re, Re, Re, Re, Gd, Gd, Gd, Dd, Dd, Dd, Dd, Dd, Dd, Hd, Dd, Dd, Dd, Dd, Dd, Hd, Hd, Dd, Dd, Rd, Dd, Dd, Dd, Dd, Dd, Dd, Dd^Vdt, Dd, Dd, Dd, Dd, Dd, Ds, Dd, Dd, Dd
Re, Gd^Fmw, Gd^Fmw, Gd, Gd, Gd, Rd, Gd, Gd, Re, Gd, Gd, Dd, Dd, Dd, Dd, Dd, Dd, Dd, Dd, Dd, Dd, Dd, Qlf, Dd, Dd, Ds, Dd, Hd, Dd, Rd, Dd, Dd, Dd, Dd, Dd, Ds, Dd, Dd, Dd, Dd, Dd, Dd, Dd, Dd, Dd, Dd
Re, Re, Re, Re, Re, Gd, Gd, Gd, Gd, Gd, Dd, Dd, Dd, Dd, Dd, Dd, Dd, Dd, Dd, Dd, Rd, Dd, Rd, Rd, Dd, Dd, Ds, Hd, Dd, Dd, Dd, Rd, Dd, Dd, Mdd, Ds, Mdd, Ds, Ds, Ql, Ql, Ql, Rd, Rd, Rd, Dd, Dd
Re, Re, Re, Re, Gd, Gd, Dd, Gd, Dd, Dd, Dd, Dd, Dd, Dd, Dd, Dd, Dd, Dd, Dd, Dd, Dd, Dd, Dd, Dd, Dd, Ds, Dd, Hd, Dd, Dd, Dd, Rd, Dd, Dd, Mdd, Mdd, Mdd, Mdd, Mdd, Dd, Dd, Dd, Rd, Dd, Dd, Dd, Dd
Re, Re, Ww, Re, Dd, Dd, Gd, Dd, Dd, Dd, Dd, Dd, Dd, Dd, Dd, Dd, Dd, Dd, Dd, Dd, Dd, Dd, Dd, Dd, Dd, Dd, Dd, Dd, Dd, Dd, Dd, Dd, Mdd, Mdd, Mdd, Mdd, Mdd, Mdd, Dd, Dd, Dd, Dd, Dd, Dd, Dd, Dd, Dd
