Xoi, Xoi, Xoi, Xoi, Xoi, Xoi, Xoi, Xoi, Xoi, Xoi, Xoi, Xoi, Xoi, Xoi, Xoi, Xoi, Xoi, Xoi, Xoi, Xoi, Xoi, Xoi, Xoi, Xoi, Xoi, Xoi, Xoi, Xoi, Xoi, Xoi, Xoi, Xoi
Xoi, Irs, 4 Kud, Irs, Ch, Iwr, Iwr, Xoi, Xoi, Xoi, Xoi, Xoi, Xoi, Xoi, Xoi, Xoi, Xoi, Xoi, Xoi, Xoi, Xoi, Xoi, Xoi^Efs, Xoi, Xoi, Xoi, Xoi, Xoi, Gg^Ve, Gg^Ve, Gg^Ve, Xoi
Xoi, Irs, Ch, Ch, Iwr, Iwr, Iwr, Xoi^Efs, Xoi^Efs, Xoi, Xoi, Xoi, Xoi, Xoi, Xoi, Xoi, Xoi, Xoi, Irs, Irs, Irs, Irs, Irs, Xoi^Efs, Xoi, Xoi, Xoi, Xoi, Xoi, Xoi, Xoi, Xoi
Xoi, Xoi, Iwr, Iwr, Iwr, Iwr, Icn, Iwr, Xoi, Xoi, Xoi, Xoi, Xoi, Xoi, Xoi, Xoi, Xoi, Irs, Irs, Irs, Irs, Irs, Irs, Irs, Irs, Xoi, Xoi, Xoi, Xoi, Xoi, Xoi, Xoi
Xoi, Iwr, Iwr^TabY, Iwr^TabY, Icn, Icn, Icn, Icn, Iwr, Xoi, Iwr, Xoi^Efs, Iwr, Xoi^Efs, Iwr, Xoi, Xoi, Irs, Irs, Irs, Irs, Irs, Irs, Irs, Irs, Xoi, Xoi, Xoi, Xoi, Xoi, Xoi, Xoi
Xoi, Iwr, Iwr, Icn, Icn, Icn, Iwr, Iwr, Iwr, Iwr, Iwr, Iwr, Iwr, Iwr, Iwr, Iwr, Xoi, Irs, Irs, Irs, Irs, Irs, Irs, Irs, Xoi, Xoi, Xoi, Xoi, Xoi, Xoi, Xoi, Xoi
Xoi, Xoi, Xoi, Xoi, Xoi, Iwr, Xoi, Xoi, Xoi, Iwr, Xoi, Iwr, Xoi, Iwr, Iwr, Iwr, Xoi, Xoi, Irs, Irs, Irs, Irs, Xoi, Xoi, Xoi, Xoi, Xoi, Xoi, Xoi, Xoi, Xoi, Xoi
Xoi, Xoi, Xoi, Xoi, Xoi, Xoi, Xoi, Xoi, Xoi, Xoi, Xoi, Xoi, Xoi, Iwr, Iwr, Iwr, Xoi, Xoi, Xoi, Irs, Xoi, Xoi, Xoi, Xoi, Xoi, Xoi, Xoi, Xoi, Yf, Xoi, Xoi, Xoi
Xoi, Xoi, Xoi, Xoi, Xoi, Xoi, Xoi, Xoi, Xoi, Xoi, Xoi, Xoi, Xoi, Xoi, Xoi, Xoi, Xoi, Xoi, Xoi, Xoi, Xoi^Efs, Xoi^Efs, Yf, Xoi, Xoi, Xoi, Xoi, Yf, Yf, Yf, Xoi, Xoi
Xoi, Xoi, Xoi, Xoi, Xoi, Xoi, Xoi, Xoi, Xoi, Xoi, Xoi, Xoi, Xoi, Iwr, Iwr, Iwr, Xoi, Xoi, Xoi, Xoi, Yf, Yf, Yf, Xoi, Xoi, Xoi, Yf, Yf, Yf, Yf, Xoi, Xoi
Xoi, Xoi, Xoi, Xoi, Xoi, Xoi, Xoi, Xoi, Xoi, Xoi, Xoi, Xoi, Xoi, Iwr, Iwr, Iwr, Xoi, Xoi, Yf, Yf, Yf, Yf, Yf, Xoi, Xoi, Xoi, Yf, Yf, Yf, Yf, Xoi, Xoi
Xoi, Xoi, Xoi, Xoi, Xoi, Xoi, Xoi, Xoi, Xoi, Xoi, Xoi, Xoi, Xoi, Iwr, Iwr, Iwr, Xoi, Yf, Yf, Yf, Yf, Yf, Yf, Xoi, Xoi, Xoi, Yf, Yf, Yf, Yf, Xoi, Xoi
Xoi, Xoi, Xoi, Xoi, Xoi, Xoi, Xoi, Xoi, Xoi^Efs, Xoi^Efs, Iwr, Xoi, Iwr, Iwr, Iwr, Iwr, Xoi, Yf, Yf, Yf, Yf, Yf, Yf, Xoi, Xoi, Xoi, Yf, Yf, Yf, Yf, Xoi, Xoi
Xoi, Xoi, Xoi, Xoi, Xoi, Xoi, Xoi^Efs, Xoi, Iwr, Iwr, Iwr, Iwr, Iwr, Iwr, Iwr, Iwr, Xoi, Xoi, Xoi, Yf, Yf, Yf, Yf, Xoi, Xoi, Xoi, Yf, Yf, Yf, Yf, Xoi, Xoi
Xoi, Xoi, Xoi, Xoi, Xoi, Xoi^Efs, Iwr, Iwr, Iwr, Iwr, Xoi, Xoi, Xoi, Iwr, Iwr, Iwr, Xoi, Xoi, Xoi, Xoi, Xoi, Xoi, Yf^Ii, Xoi, Xoi, Xoi, Xoi, Yf, Yf, Yf, Xoi, Xoi
Xoi, Xoi, Xoi^Efs, Xoi^Efs, Iwr, Iwr, Iwr, Iwr, Xoi, Xoi, Xoi, Xoi, Xoi, Iwr, Iwr, Iwr, Xoi, Xoi, Xoi, Xoi, Xoi, Xoi, Xoi, Yf^Ii, Xoi, Xoi, Xoi, Yf, Xoi, Xoi, Xoi, Xoi
Xoi, Xoi, Iwr, Iwr, Iwr^TabY, Iwr, Iwr, Xoi, Xoi, Xoi, Xoi, Xoi, Xoi, Icn, Icn, Icn, Xoi, Xoi, Xoi, Xoi, Xoi, Xoi, Xoi, Xoi, Xoi, Xoi, Xoi, Xoi, Xoi, Xoi, Xoi, Xoi
Xoi, Iwr, Iwr^TabY, Iwr, Iwr, Iwr, Xoi, Xoi, Xoi, Xoi, Xoi, Xoi, Xoi, Icn, Iwr, Icn, Xoi, Xoi, Xoi, Xoi, Xoi, Xoi, Xoi, Xoi, Xoi, Xoi, Xoi, Xoi, Xoi, Xoi, Xoi, Xoi
Xoi, Iwr, Iwr, Iwr, Xoi, Xoi, Xoi^Efs, Xoi, Xoi, Xoi, Xoi, Xoi, Xoi^Efs, Iwr, Iwr, Iwr, Xoi^Efs, Xoi, Xoi, Xoi, Xoi, Xoi, Xoi, Xoi, Xoi, Xoi, Xoi, Xoi, Xoi, Xoi, Xoi, Xoi
Xoi, Iwr, Iwr, Xoi, Xoi, Xoi^Efs, Iwr, Iwr, Iwr, Xoi, Xoi, Xoi^Efs, Iwr, Iwr, Iwr, Iwr, Iwr, Xoi^Efs, Xoi, Xoi, Xoi, Xoi, Xoi^Efs, Xoi, Xoi, Xoi, Xoi, Xoi, Xoi, Xoi, Xoi, Xoi
Xoi, Iwr, Iwr, Xoi, Xoi, Iwr, Iwr, Iwr, Iwr, Iwr, Iwr, Iwr, Iwr, Iwr, Xoi, Iwr, Iwr, Iwr, Iwr, Iwr, Xoi, Yf, Yf, Xoi^Efs, Xoi, Xoi, Xoi, Xoi, Xoi, Xoi, Xoi, Xoi
Xoi, Iwr, Iwr, Xoi, Xoi, Iwr, Iwr, Iwr, Iwr, Iwr, Iwr, Iwr, Iwr, Xoi, Xoi^Efs, Xoi, Iwr, Iwr, Iwr, Iwr, Xoi, Yf, Yf, Yf, Xoi, Xoi, Xoi, Xoi, Xoi, Xoi, Xoi, Xoi
Xoi, Iwr, Iwr, Xoi, Xoi, Iwr, Iwr, Iwr, Xoi, Iwr, Xoi, Iwr, Iwr, Iwr, Iwr, Iwr, Iwr, Xoi, Xoi, Iwr, Xoi, Yf, Yf, Yf, Xoi, Xoi, Xoi, Xoi, Xoi, Xoi, Xoi, Xoi
Xoi, Iwr, Iwr, Xoi, Xoi, Iwr, Iwr, Xoi, Xoi, Xoi, Xoi^Efs, Xoi, Xoi, Iwr, Iwr, Iwr, Xoi, Xoi, Xoi, Xoi, Xoi, Yf, Yf, Yf^Ii, Xoi, Xoi, Xoi, Xoi, Xoi, Xoi, Xoi, Xoi
Xoi, Iwr, Iwr, Xoi, Xoi, Iwr, Iwr, Xoi, Xoi, Xoi^Efs, Ior, Xoi, Xoi, Iwr, Iwr, Iwr, Xoi, Xoi, Xoi, Xoi, Xoi, Yf, Yf, Yf^Ii, Xoi, Xoi, Xoi, Xoi, Xoi, Xoi, Xoi, Xoi
Xoi, Iwr, Iwr, Xoi, Xoi, Iwr, Xoi, Xoi, Xoi, Ior, Ior, Xoi, Xoi, Icn, Icn, Icn, Xoi, Xoi, Xoi, Xoi, Xoi, Yf, Yf^Ii, Yf^Ii, Xoi, Xoi, Xoi, Xoi, Xoi, Xoi, Xoi, Xoi
Xoi, Iwr, Iwr, Xoi^Efs, Xoi^Efs, Xoi, Xoi, Xoi, Xoi, Ior, Ior, Xoi, Xoi, Icn, Iwr, Icn, Xoi, Xoi, Xoi, Xoi, Xoi, Yf^Ii, Xoi, Yf^Ii, Xoi, Xoi, Xoi, Xoi, Xoi, Xoi, Xoi, Xoi
Xoi, Ch, Ch, Ch, Iwr, Xoi, Iwr^TabY, Xoi^Efs, Ior, Ior, Ior, Xoi, Xoi^Efs, Iwr, Iwr, Iwr, Xoi^Efs, Xoi, Xoi, Xoi, Xoi, Xoi, Xoi, Xoi, Xoi, Xoi, Xoi, Xoi, Xoi, Xoi, Xoi, Xoi
Xoi, Ch, 3 Kh, Ch, Xoi, Iwr, Iwr, Iwr, Xoi, Ior, Ior, Xoi^Efs, Iwr, Iwr, Iwr, Iwr, Iwr, Xoi^Efs, Xoi, Xoi, Xoi, Xoi, Xoi, Xoi, Xoi, Xoi, Xoi, Xoi, Xoi, Xoi, Xoi, Xoi
Xoi, Xoi, Xoi, Xoi, Xoi, Xoi, Xoi, Xoi, Xoi, Xoi, Xoi, Xoi, Iwr, Ch, Ch, Ch, Iwr, Xoi, Xoi, Xoi, Xoi, Xoi, Xoi, Xoi, Xoi, Xoi, Xoi, Xoi, Xoi, Xoi, Xoi, Xoi
Xoi, Xoi, Xoi, Xoi, 2 Xoi, Xoi, Xoi, Xoi, Xoi, Xoi, Xoi, Xoi, Iwr, Ch, 1 Kh, Ch, Iwr, Xoi, Xoi, Xoi, Xoi, Xoi, Xoi, Xoi, Xoi, Xoi, Xoi, Xoi, Xoi, Xoi, 5 Kh, Xoi
Xoi, Xoi, Xoi, Xoi, Xoi, Xoi, Xoi, Xoi, Xoi, Xoi, Xoi, Xoi, Xoi, Iwr, Iwr, Iwr, Xoi, Xoi, Xoi, Xoi, Xoi, Xoi, Xoi, Xoi, Xoi, Xoi, Xoi, Xoi, Xoi, Xoi, Xoi, Xoi
Xoi, Xoi, Xoi, Xoi, Xoi, Xoi, Xoi, Xoi, Xoi, Xoi, Xoi, Xoi, Xoi, Iwr, Iwr, Iwr, Xoi, Xoi, Xoi, Xoi, Xoi, Xoi, Xoi, Xoi, Xoi, Xoi, Xoi, Xoi, Xoi, Xoi, Xoi, Xoi
Xoi, Xoi, Xoi, Xoi, Xoi, Xoi, Xoi, Xoi, Xoi, Xoi, Xoi, Xoi, Xoi, Xoi, Iwr, Xoi, Xoi, Xoi, Xoi, Xoi, Xoi, Xoi, Xoi, Xoi, Xoi, Xoi, Xoi, Xoi, Xoi, Xoi, Xoi, Xoi
