Mm, Mm, Mm, Mm, Mm, Mm, Hh, Hh, Hh, Mm, Mm, Mm, Mm, Mm, Mm^Xm, Mm, Re, Mm, Mm, Ww, Mm, Mm, Mm, Mm^Xm, Mm, Gg, Gg, Gg, Gg, Re, Gg, Gg, Mm, Mm, Mm, Mm, Mm, Mm, Mm, Mm, Mm^Xm, Mm, Mm^Xm, Mm, Mm, Mm, Mm
Mm, Mm, Mm, Mm, Mm, Mm, Hh, Hh, Hh, Mm, Mm, Mm, Mm, Mm, Mm^Xm, Mm, Re, Mm, Mm, Ww, Mm, Mm, Mm, Mm^Xm, Mm, Gg, Gg, Gg, Gg, Re, Gg, Gg, Mm, Mm, Mm, Mm, Mm, Mm, Mm, Mm, Mm^Xm, Mm, Mm^Xm, Mm, Mm, Mm, Mm
Mm, Mm, Mm, Mm, Mm, Hh, Mm, Mm, Mm, Mm, Mm^Xm, Mm, Mm, Mm^Xm, Hh, Mm, Mm, Re, Re, Mm, Mm, Mm, Mm, Mm, Mm, Hh, Hh, Gg, Chr, Chr, Chr, Hh, Mm, Mm, Mm, Mm, Mm, Mm, Mm, Mm^Xm, Mm^Xm, Mm^Xm, Mm, Mm^Xm, Mm, Mm, Mm
Mm, Mm, Mm, Mm, Mm, Mm, Mm, Mm, Mm^Xm, Mm^Xm, Mm^Xm, Mm^Xm, Mm^Xm, Mm, Mm, Mm, Mm, Mm, Re, Mm, Mm, Mm, Mm, Mm^Vhh, Hh, Hh, Mm, Hh, Chr, 1 Khr, Chr, Hh, Hh, Mm, Mm, Mm, Mm, Mm, Mm, Hh, Mm, Mm, Mm, Mm, Mm, Mm, Mm
Mm, Mm, Hh, Mm, Mm, Mm, Mm^Xm, Mm^Xm, Mm^Xm, Mm^Xm, Mm^Xm, Mm^Xm, Mm, Mm, Mm, Mm, Mm, Mm, Re, Hh, Hh, Mm, Mm, Mm, Hh, Hh, Hh, Hh, Hh, Chr, Hh, Hh, Hh, Hh, Mm, Mm, Hh, Hh, Mm, Mm, Hh, Hh, Mm, Mm, Hh, Mm, Mm
Hh, Hh, Hh, Mm, Mm, Mm^Xm, Mm^Xm, Mm^Xm, Mm^Xm, Mm^Xm, Mm, Mm, Mm, Mm, Mm, Mm, Mm, Hh, Re, Hh, Hh, Hh, Hh, Hh, Hh, Hh, Hh, Hh, Hh, Re, Hh, Hh, Hh, Hh^Vhh, Mm, Hh, Hh, Mm, Mm, Mm, Mm, Mm, Mm, Mm^Xm, Mm, Mm, Mm
Hh, Hh^Vhh, Mm, Mm, Mm^Xm, Mm^Xm, Mm^Xm, Mm^Xm, Mm, Mm, Mm, Mm, Mm, Mm, Mm, Mm, Hh, Re, Hh, Hh, Hh, Hh, Hh, Hh, Hh, Gg, Gg, Gg, Gg, Re, Hh, Hh, Hh, Gg^Efm, Mm, Mm, Mm, Mm, Hh, Hh, Mm, Mm, Mm, Mm^Xm, Mm, Mm, Mm
Mm, Mm, Hh, Mm, Mm^Xm, Mm^Xm, Mm, Mm, Mm, Hh, Hh, Mm, Mm, Mm, Mm, Mm, Hh, Re, Hh, Hh, Hh^Es, Hh, Hh, Hh, Gs^Fp, Hh, Hh, Gg, Re, Re, Hh, Gg, Hh, Mm, Mm, Mm, Mm^Xm, Mm, Mm^Xm, Mm^Xm, Mm, Mm, Mm, Mm, Mm, Mm, Mm
Mm, Mm, Mm, Mm, Mm, Mm, Mm, Mm, Mm, Mm, Hh^Vhh, Hh, Hh, Hh, Hh, Hh, Hh, Re, Hh, Hh, Hh, Hh, Hh, Gg, Gs^Fp, Gs^Fp, Gs^Fp, Gg, Re, Gg, Hh, Gg, Hh, Hh, Mm, Mm^Xm, Mm^Xm, Mm^Xm, Mm^Xm, Mm^Xm, Mm^Xm, Mm, Hh, Hh, Mm, Mm, Mm
Mm, Mm, Mm, Hh, Mm, Mm, Mm, Hh, Hh, Hh, Hh, Hh, Hh, Hh, Hh, Hh, Hh, Re, Re, Hh, Hh, Hh, Gs^Fp, Gs^Fp, Gs^Fp, Gg, Gg, Re, Gg, Gg, Hh, Hh, Gg^Vc, Hh, Hh, Mm, Hh, Mm^Xm, Mm^Xm, Mm^Xm, Mm^Xm, Mm, Mm, Mm, Mm, Mm, Mm
Mm, Mm, Mm, Mm, Mm^Xm, Mm^Xm, Mm^Xm, Mm, Hh, Hh, Hh, Hh, Hh, Hh, Hh, Hh, Hh, Hh, Re, Gs^Fp, Gs^Fp, Gs^Fp, Gs^Fp, Gs^Fp, Gs^Fp, Gg, Re, Re, Gg, Gg, Gg, Hh, Hh, Hh, Mm, Mm, Mm^Xm, Mm^Xm, Mm, Hh, Mm, Mm^Xm, Mm, Mm^Xm, Mm^Xm, Hh, Hh
Mm, Mm, Mm, Mm, Mm^Xm, Mm^Xm, Mm^Xm, Mm, Mm, Mm, Mm, Hh, Hh, Hh, Hh, Hh, Hh, Gg, Re, Gg, Gg, Gs^Fp, Gs^Fp, Gs^Fp, Gg, Gg, Re, Gg, Gg, Gg, Gg, Hh, Hh, Mm, Mm^Xm, Mm^Xm, Mm^Xm, Mm, Mm, Mm, Hh, Mm, Mm, Mm^Xm, Mm^Xm, Mm, Mm
Mm, Mm, Mm, Mm^Xm, Mm, Mm^Xm, Mm, Mm, Hh, Mm, Hh, Gg, Hh, Hh, Hh, Hh, Hh, Gg, Re, Gg, Gs^Fp, Gs^Fp, Gs^Fp, Gg, Gg, Gg, Gg, Gg, Gg, Gg, Gg, Gg, Mm, Mm, Mm, Mm^Xm, Hh, Hh, Chr, Chr, Chr, Mm, Mm, Mm, Mm^Xm, Mm, Mm
Mm, Mm, Mm, Mm, Mm, Mm, Mm, Mm, Hh, Hh, Ww, Ww, Ww, Hh, Hh, Hh, Gs^Fp, Gg, Re, Gg, Gs^Fp, Gg^Vht, Gg, Gg, Re, Re, Gs^Fp, Gg, Gg, Gg, Gg, Gs^Fp, Mm, Mm, Mm^Xm, Mm^Xm, Mm, Hh, Chr, 2 Khr, Chr, Gs^Fp, Mm, Mm^Xm, Mm^Xm, Mm^Xm, Mm^Xm
Mm, Mm, Mm^Xm, Mm, Mm, Mm, Mm, Hh, Hh, Gg, Ww, Ww, Ww, Hh, Gs^Fp, Gs^Fp, Ww, Gg, Re, Gg, Gg, Gs^Fp, Gg, Gg, Re, Gg, Gg, Gg, Gs^Fp, Gg, Gg, Gs^Fp, Mm, Mm^Xm, Mm, Mm, Hh, Hh, Hh, Hh, Re, Mm, Gs^Fp, Gg^Vh, Mm^Xm, Mm^Xm, Mm^Xm
Gs^Fp, Gs^Fp, Mm^Xm, Mm, Mm, Mm, Hh, Hh, Ww, Ww, Gg, Hh, Ww, Hh, Ww, Ww, Ww, Gg, Gg^Fet, Re, Gg, Gg, Gg, Re, Re, Gg, Gg, Gs^Fp, Gs^Fp, Gg, Gg, Gg, Gg^Vd, Mm, Gs^Fp, Gs^Fp, Hh, Hh, Hh, Hh, Re, Mm, Mm^Xm, Mm^Xm, Mm, Gs^Fp, Mm
Hh, Hh, Mm^Xm, Mm, Mm, Ww, Ww, Hh, Ww, Hh, Hh, Hh, Hh, Ww, Hh, Gg^Vd, Ww, Gs^Fp, Gs^Fp, Re, Gg, Gg, Re, Re, Gg, Re, Re, Gg, Gg, Gg, Re, Gg, Re, Re, Hh, Re, Re, Re, Re, Re, Mm, Mm^Xm, Mm, Mm, Mm, Gs^Fp, Re
Mm^Xm, Mm^Xm, Mm, Mm, Mm, Ww, Ww, Ww, Ww, Hh, Hh, Hh, Hh, Hh, Hh, Gg, Ww, Gg, Re, Re, Re, Re, Gg, Hh, Hh, Gg, Gg, Re, Re, Re, Gg, Gg, Hh, Hh, Hh, Ww, Mm, Mm, Mm, Mm, Gg^Efm, Mm, Mm^Xm, Mm^Xm, Mm, Mm, Mm
Mm^Xm, Mm^Xm, Mm, Mm, Hh, Ww, Chw, Ww, Ww, Gg, Hh, Hh, Hh, Hh, Hh, Gg, Ww, Gg, Re, Re^Gvs, Re^Gvs, Re^Gvs, Re^Gvs, Gg, Gg, Gg, Gg, Gg, Gg, Gg, Gg, Hh, Hh, Hh, Hh, Mm, Mm, Mm, Hh, Mm, Hh, Mm, Mm^Xm, Mm, Gg^Vh, Mm^Xm, Mm^Xm
Mm, Mm, Hh^Vhh, Hh, Ww, Ww, Ww, Ww, Ww, Hh, Mm, Mm, Mm, Hh, Hh, Hh, Ww, Gg, Re, Re^Gvs, Re^Gvs, Re^Gvs, Re^Gvs, Gg, Gg, Gg, Gg, Gg, Gg^Yc, Gg, Hh, Hh, Hh, Hh, Mm, Mm, Gg, Mm, Mm, Hh, Mm, Mm, Mm, Mm, Mm, Mm^Xm, Mm^Xm
Mm, Mm, Mm, Ww, Ww, Ww, Ww, Ww, Ww, Mm, Mm, Mm, Mm, Mm, Hh, Hh, Ww, Gg, Re, Re^Gvs, Re^Gvs, Re^Gvs, Re^Gvs, Gg, Gg, Gg, Gg, Gg^Yc, Gg, Gg, Hh, Hh, Hh, Hh, Mm, Gg, Mm, Mm^Xm, Mm, Mm^Xm, Mm^Xm, Mm^Xm, Mm, Mm, Mm, Mm, Mm
Mm, Mm, Mm, Mm, Mm, Mm, Mm, Mm, Mm, Mm, Mm, Mm, Mm, Mm, Hh, Hh, Gg, Ww, Re, Re^Gvs, Re^Gvs, Re^Gvs, Gg, Gg, Gg, Gg, Gg^Yc, Gg^Yc, Gg, Gg, Hh, Hh, Ww, Mm, Mm, Mm, Mm, Mm, Mm, Mm, Mm, Mm, Mm, Mm^Xm, Mm^Xm, Mm, Mm
Mm, Mm, Mm, Mm, Mm, Mm^Xm, Mm^Xm, Mm, Mm, Mm^Xm, Mm^Xm, Mm, Mm, Mm, Hh, Hh, Gg, Ww, Chr, Ww, Ww, Gg, Gg, Gg, Gg^Vd, Gg, Gg, Gg, Gg, Gg, Hh, Ww, Mm, Mm, Mm, Mm, Mm, Mm, Mm, Mm, Mm^Xm, Mm, Mm, Mm^Xm, Mm, Mm, Mm
Hh, Hh, Mm, Mm, Mm, Mm, Mm, Mm^Xm, Mm^Xm, Mm^Xm, Mm, Mm^Xm, Hh, Mm, Hh, Hh, Gg, Ww, Gs^Fp, Re, Ww, Ww, Ww, Ww^Bw|, Ww, Ww, Ww, Ww, Ww, Ww, Ww, Ww, Gg, Hh, Gg^Vh, Mm, Hh, Hh, Mm, Mm, Mm^Xm, Mm, Mm^Xm, Mm^Xm, Hh, Mm, Mm
Mm, Mm, Hh, Mm, Mm, Mm, Mm^Xm, Mm^Xm, Mm, Mm, Mm^Xm, Mm, Mm, Mm, Hh, Hh, Gs^Fp, Gs^Fp, Gg, Re, Gg, Ww, Gg, Gg, Gg, Gg, Gg, Gg, Hh, Hh, Hh, Hh, Hh, Hh, Hh, Hh, Mm, Mm, Mm^Xm, Mm^Xm, Mm^Xm, Mm^Xm, Mm, Mm^Xm, Mm, Mm, Mm
Gg, Gg, Mm, Hh, Mm, Mm^Xm, Mm^Xm, Mm^Xm, Mm^Xm, Mm^Xm, Mm, Mm, Mm, Hh, Hh, Hh, Gg, Gg, Gg, Re, Hh, Gg, Gg, Hh, Hh, Hh, Hh, Hh, Hh, Hh, Mm, Mm, Hh, Mm, Mm, Mm, Mm, Mm^Xm, Mm^Xm, Mm, Mm, Mm, Mm, Mm^Xm, Mm^Xm, Mm^Xm, Mm^Xm
Mm, Mm, Mm, Mm, Hh, Mm, Mm, Mm, Mm, Mm, Mm, Mm, Hh, Hh, Hh, Gs^Fp, Gs^Fp, Gg, Re, Re, Gg, Gg, Gg, Gg, Hh, Hh, Hh, Hh, Hh, Mm, Mm, Mm, Mm, Mm, Mm, Mm, Mm^Xm, Mm^Xm, Mm, Mm, Mm, Mm, Mm, Hh, Mm^Xm, Mm^Xm, Mm^Xm
Mm, Mm, Mm, Mm, Hh, Hh, Mm, Mm, Mm, Hh, Ww, Ww, Ww, Hh, Hh, Gs^Fp, Gg^Vc, Gs^Fp, Re, Gg, Gg, Gg, Gg, Hh, Hh, Hh, Hh, Hh, Hh, Mm, Mm, Mm, Mm, Mm, Mm^Xm, Mm^Xm, Mm^Xm, Mm^Xm, Hh^Vhh, Mm, Mm, Mm, Mm, Mm^Xm, Mm^Xm, Mm^Xm, Mm^Xm
Mm^Xm, Mm^Xm, Mm, Gg, Ww, Ww, Ww, Mm, Ww, Ww, Ds, Ww, Ww, Hh, Gs^Fp, Gs^Fp, Re, Re, Gs^Fp, Re, Re, Gg, Gg, Gg, Gg, Gg, Hh, Hh, Hh, Mm, Mm, Mm, Mm, Mm^Xm, Mm, Mm, Ss, Ss, Ss, Hh, Hh, Mm, Mm, Mm, Mm^Xm, Mm, Mm
Mm^Xm, Mm^Xm, Mm^Xm, Gs^Fp, Ww, Ww, Ww, Ww, Ww, Mm, Mm, Mm, Mm, Ww, Gs^Fp, Gs^Fp, Re, Gs^Fp, Gs^Fp, Gs^Fp, Gg, Re, Re, Gg, Gg, Gg, Gg, Hh, Hh, Mm, Mm, Mm, Mm^Xm, Mm^Xm, Mm^Xm, Mm, Ss, Chs, Chs, Ss, Ss, Hh, Mm, Mm^Xm, Mm, Mm^Xm, Mm^Xm
Mm, Mm, Mm^Xm, Mm, Ww, Ww, Ww, Ww, Mm, Mm, Mm, Mm, Mm, Ww, Gg, Re, Gs^Fp, Gs^Fp, Gg^Fet, Gs^Fp, Gs^Fp, Gg, Gg, Re, Re, Gg, Gg, Hh, Hh, Hh, Mm, Mm, Mm^Xm, Mm^Xm, Mm^Xm, Mm, Ss, Chs, 4 Khs, Chs, Ss, Mm, Ss, Mm^Xm, Mm^Xm, Mm, Mm
Mm, Mm, Mm^Xm, Mm, Ww, Ww, Ww, Ww, Ww, Mm, Mm, Mm, Mm, Ww, Ww, Re, Gg, Gs^Fp, Gs^Fp, Gs^Fp, Gs^Fp, Ww, Ww, Ww, Gg, Re, Gg^Vd, Hh, Hh, Hh, Hh, Mm, Mm, Mm^Xm, Mm^Xm, Mm, Mm, Chs, Ss, Ss, Ss, Ss, Mm, Mm^Xm, Mm^Xm, Mm^Xm, Mm^Xm
Mm, Mm, Mm^Xm, Mm^Xm, Mm, Ww, Ww, Ww, Mm, Mm, Mm^Xm, Mm^Xm, Mm, Mm, Chw, Re, Gg^Vd, Gs^Fp, Gs^Fp, Gs^Fp, Gs^Fp, Ww, Ww, Ww, Gg, Re, Re, Hh, Hh, Hh, Hh, Hh, Mm^Xm, Mm^Xm, Mm, Mm, Chs, Chs, Ss, Ss, Ss^Vm, Mm, Mm^Xm, Mm^Xm, Mm^Xm, Ww, Ww
Mm, Mm, Mm, Mm, Mm, Mm, Ww, Hh^Vhh, Mm, Mm, Mm^Xm, Chr, Chr, Mm, Re, Ww, Ww, Wwf, Wwf, Ww, Ww, Ww, Ww, Ww, Gg, Gg, Re, Gg, Hh, Hh, Hh, Mm, Mm^Xm, Ss^Vm, Ss, Ss, Chs, Ss, Ss, Ss, Chs, Mm, Mm, Mm, Mm, Mm^Xm, Mm^Xm
Mm, Mm, Gg, Mm, Mm, Mm, Ww, Mm, Mm^Xm, Mm^Xm, Mm, Chr, Mm, Mm, Mm, Ww, Ww, Gs^Fp, Gs^Fp, Gs^Fp, Gg, Gg, Gg, Ww, Hh, Hh, Re, Re^Gvs, Re^Gvs, Hh, Hh, Mm, Mm^Xm, Ss, Hh, Ss, Ss, Ss, Chs, Chs, Mm, Mm, Mm, Mm, Mm^Xm, Mm^Xm, Mm^Xm
Gs^Fp, Gs^Fp, Gg, Mm, Mm, Mm, Mm^Xm, Mm^Xm, Mm, Mm^Xm, Mm, Mm, Mm, Hh, Re, Gg, Gg, Gs^Fp, Gs^Fp, Gg, Gg, Gg, Hh, Ww, Hh, Gg, Re, Re^Gvs, Re^Gvs, Hh, Hh, Mm, Mm, Mm^Xm, Mm^Xm, Ss, Ss, Ss, Chs, Chs, Mm, Mm, Mm, Mm, Mm^Xm, Mm, Mm
Gg, Gg, Gs^Fp, Mm, Mm, Mm, Mm^Xm, Mm, Mm, Mm, Gg, Mm, Mm, Hh, Re, Gg, Gg, Gg, Gg, Gg, Gg, Hh, Hh, Ww, Hh, Hh, Re, Re^Gvs, Hh, Hh, Hh, Hh, Mm, Mm, Mm^Xm, Ss, Ss, Ss, Ss, Ss, Ss, Hh, Hh, Mm^Xm, Mm^Xm, Mm, Mm
Gg, Gg, Mm, Mm, Mm^Xm, Mm^Xm, Mm^Xm, Mm^Xm, Mm, Hh, Gg, Gg, Hh, Hh, Gg, Gs^Fp, Gs^Fp, Gg, Gg, Gg, Gg, Gg, Hh, Ww, Hh, Gg, Gg, Re, Hh, Hh, Hh, Ss, Mm, Mm, Mm, Mm, Chs, Ss, Ss, Ss, Mm, Ss, Ss, Mm, Mm^Xm, Mm, Mm
Mm, Mm, Mm, Mm^Xm, Mm^Xm, Mm^Xm, Mm^Xm, Mm, Mm, Hh, Gg, Gg, Hh, Re, Gs^Fp, Gs^Fp, Gs^Fp, Gs^Fp, Gs^Fp, Gs^Fp, Gg, Gg, Gg^Vd, Ww, Ww, Gg, Gs^Fp, Re, Re, Gg, Ss, Ss, Ss, Ss, Hh^Vhh, Hh, Mm, Chs, Mm, Mm, Mm^Xm, Mm, Mm, Mm^Xm, Mm^Xm, Mm, Mm
Mm, Mm, Mm^Xm, Mm^Xm, Mm^Xm, Mm, Mm, Mm, Mm, Mm, Gg^Vd, Hh, Re, Gg, Gg, Gg, Gs^Fp, Gg^Vht, Gs^Fp, Gs^Fp, Gs^Fp, Gg, Gg, Ww, Ww, Gs^Fp, Gs^Fp, Gg, Gg, Re, Re, Ss, Hh, Ss, Ss, Ss, Ss, Ss, Mm, Mm^Xm, Mm, Mm, Mm, Mm, Mm^Xm, Mm^Xm, Mm
Mm, Mm, Mm, Mm, Gg, Mm, Hh, Chr, Chr, Chr, Re, Re, Gg, Gg, Gg, Gg, Gs^Fp, Gs^Fp, Gs^Fp, Gg, Gs^Fp, Gs^Fp, Gs^Fp, Gg, Ww, Gs^Fp, Gs^Fp, Gg, Ww, Ww^Bw|, Mm, Mm, Mm, Ss, Hh, Ss, Mm, Ss, Mm, Mm^Xm, Mm, Mm, Mm, Mm^Xm, Mm^Xm, Gg^Ve, Mm
Mm, Mm, Mm, Mm, Gg, Mm, Hh, Chr, 3 Khr, Chr, Re, Re, Mm, Gg, Re^Gvs, Re^Gvs, Re^Gvs, Gs^Fp, Gs^Fp, Gs^Fp, Gs^Fp, Gg^Fet, Gs^Fp, Gs^Fp, Ww, Gs^Fp, Gs^Fp, Ww, Ww, Re, Mm, Mm, Hh, Hh, Hh, Hh, Hh, Hh, Mm, Mm^Xm, Mm^Xm, Mm^Xm, Hh, Mm, Mm^Xm, Mm, Mm
Mm, Mm, Mm, Mm, Mm, Mm, Mm, Gg, Chr, Hh, Mm, Mm, Mm, Mm, Mm, Re^Gvs, Gs^Fp, Gs^Fp, Gs^Fp, Gs^Fp, Gs^Fp, Gs^Fp, Gs^Fp, Gs^Fp, Ww, Gg, Ww, Ww, Gg^Vd, Re, Hh, Hh, Mm^Xm, Hh, Mm, Mm, Hh, Mm, Mm^Xm, Mm^Xm, Mm^Xm, Hh, Mm^Xm, Mm^Xm, Mm, Mm^Xm, Mm^Xm
Mm, Mm, Mm^Xm, Mm^Xm, Mm, Mm, Mm, Mm, Mm, Mm, Mm, Mm^Xm, Mm^Xm, Mm, Mm, Mm, Gg, Gg, Gg, Gg, Gg, Gg, Gs^Fp, Gg^Efm, Ww, Gs^Fp, Ww, Ww, Gg, Re, Hh, Hh, Hh, Mm, Mm, Mm, Mm^Xm, Mm^Xm, Mm, Mm^Xm, Mm^Xm, Mm, Mm^Xm, Mm, Gs^Fp, Mm^Xm, Mm^Xm
Mm, Mm, Mm^Xm, Mm^Xm, Mm^Xm, Mm, Mm, Mm, Mm, Mm, Mm, Mm, Mm, Mm^Xm, Mm^Xm, Mm, Gg, Gg, Gg^Yc, Gg, Gg^Yc, Gg^Yc, Gg, Gs^Fp, Ww, Gs^Fp, Ww, Gs^Fp, Gs^Fp, Re, Hh, Hh, Hh^Vhh, Mm, Mm, Mm^Xm, Mm^Xm, Mm, Mm^Xm, Mm, Mm, Mm^Xm, Mm, Gs^Fp, Mm, Mm^Xm, Mm^Xm
Mm, Mm, Mm, Mm, Mm, Mm, Mm, Mm, Mm, Mm, Mm, Mm, Mm, Mm^Xm, Mm, Mm, Gg^Yc, Gg^Yc, Gg, Gg^Yc, Gg, Gg, Gg, Gg, Ww, Ww, Ww, Gs^Fp, Gs^Fp, Re, Re, Mm, Mm, Mm, Mm, Mm, Hh, Mm, Mm, Mm^Xm, Mm, Mm, Mm, Mm, Mm, Mm^Xm, Mm^Xm
Mm, Mm, Mm, Mm, Mm, Mm, Mm, Mm, Mm, Mm, Mm, Mm, Mm, Mm^Xm, Mm, Mm, Gg^Yc, Gg, Gg, Gg, Gg, Gg, Gg, Gg, Ww, Ww, Ww, Gs^Fp, Gs^Fp, Re, Re, Mm, Mm, Mm, Mm, Mm, Mm, Mm, Mm, Mm^Xm, Mm, Mm, Mm, Mm, Mm, Mm^Xm, Mm^Xm
