border_size=1
usage=map

Hh          , Hh          , Hh          , Ww          , Ww          , Ww          , Ww          , Ww          , Hh          , Hh          , Ww          , Hh          , Hh          , Hh          , Hh          , Hh          , Hh          , Ww          , Hh          , Hh          , Mm^Xm       , Ww          , Mm          , Mm          , Mm          , Mm          , Hh          , Hh          , Hh          , Hh          , Ww          , Hh          , Hh          , Gs          , Gs          , Hh          , Ww          , Mm          , Mm          , Mm          , Mm          , Mm          , Mm          , Mm          , Hh          , Hh          , Hh          , Hh          , Gs          , Gs          , Re          , Gs^Fms      , Gs^Fms      , Gs^Fms      , Gs          , Ww          , Ww          , Ww          , Ww          , Ww          , Ww          , Ww          
Ww          , Hh          , Ww          , Ww          , Ww          , Ww          , Ww          , Gs          , Ww          , Ww          , Ww          , Hh          , Hh          , Hh          , Hh          , Hh          , Hh          , Hh          , Mm          , Mm          , Mm^Xm       , Ww          , Ww          , Ww          , Ww          , Mm          , Hh          , Hh          , Hh          , Ww          , Hh          , Hh          , Hh          , Hh          , Hh          , Hh          , Hh          , Ww          , Ww          , Ww          , Ww          , Mm          , Hh          , Hh          , Hh^Vhh      , Hh          , Gs^Fms      , Gs^Fms      , Gs          , Gs          , Gs^Fms      , Re          , Gs          , Gs^Fms      , Gs^Fms      , Ww          , Gg^Vc       , Gs          , Gs          , Ww          , Ww          , Ww          
Ww          , Ww          , Ww          , Ww          , Ww          , Ww          , Ww          , Ww          , Hh          , Hh          , Hh          , Hh          , Hh          , Hh          , Hh          , Hh          , Hh          , Hh          , Hh          , Hh          , Mm          , Mm^Xm       , Mm^Xm       , Ww          , Mm          , Ww          , Ww          , Gs^Vht      , Ww          , Ww          , Hh          , Hh          , Hh          , Hh          , Hh          , Hh          , Hh          , Hh          , Hh          , Hh          , Ww          , Ww          , Hh          , Hh          , Hh          , Gs^Fms      , Gs^Fms      , Gs^Fms      , Gg^Vc       , Gs          , Gs          , Re          , Re          , Gs          , Gs          , Ww          , Hh          , Ww          , Gs          , Ww          , Ww          , Ww          
Ww          , Ww^Vm       , Hh          , Ww          , Ww          , Ww          , Ww          , Ww          , Hh          , Hh          , Hh          , Hh          , Hh          , Hh          , Hh          , Hh          , Hh          , Mm          , Mm^Xm       , Mm^Xm       , Mm^Xm       , Mm          , Mm          , Mm^Xm       , Mm          , Mm          , Ww          , Ww          , Hh          , Ww          , Hh          , Hh          , Hh          , Hh          , Hh          , Hh          , Hh          , Hh          , Hh          , Hh          , Hh          , Ww          , Hh          , Hh          , Gs^Fms      , Gs^Fms      , Gs^Fms      , Ww          , Ww          , Gs          , Gs          , Gs          , Re          , Gs          , Gs          , Ww          , Hh          , Ww          , Mm^Vhh      , Ww          , Ww          , Ww          
Re          , Hh          , Hh          , Hh          , Hh          , Ww          , Hh^Vc       , Ww          , Hh          , Hh          , Hh          , Hh          , Hh          , Mm          , Mm          , Mm          , Mm^Xm       , Mm          , Mm          , Mm          , Mm          , Mm^Xm       , Mm^Xm       , Mm          , Mm          , Mm          , Hh          , Hh          , Hh          , Hh          , Hh          , Hh          , Hh          , Hh          , Hh          , Hh          , Hh          , Hh          , Hh          , Hh          , Hh          , Ww          , Ww          , Ww^Vm       , Ww          , Gs^Fms      , Ww          , Ww          , Gs          , Ww          , Ww          , Ww          , Re          , Gs          , Hh          , Gs          , Hh          , Hh          , Mm          , Ww          , Mm          , Ww          
Re          , Hh          , Ww          , Hh          , Ww          , Ww          , Hh          , Hh          , Hh          , Hh          , Hh          , Hh          , Mm          , Mm^Xm       , Mm          , Mm          , Mm^Xm       , Mm          , Mm^Xm       , Mm          , Mm^Xm       , Mm          , Mm          , Mm          , Mm          , Mm          , Hh          , Hh          , Hh          , Hh          , Hh^Yc       , Hh^Yc       , Hh          , Hh          , Hh          , Hh          , Gs^Uf       , Hh          , Hh          , Hh          , Hh          , Gs          , Gs          , Ww          , Gs^Fms      , Ww          , Ww          , Gs          , Gs          , Ww          , Hh          , Hh          , Ww          , Gs          , Ww          , Hh          , Mm          , Mm          , Mm          , Mm          , Mm          , Mm          
Re          , Hh          , Ww          , Ww          , Hh          , Hh          , Hh          , Hh          , Hh          , Hh          , Hh          , Hh          , Hh          , Hh          , Mm          , Hh          , Mm          , Mm^Xm       , Mm          , Mm^Xm       , Mm          , Mm          , Mm          , Mm          , Mm          , Hh          , Hh          , Hh          , Hh          , Hh^Yc       , Hh          , Hh          , Hh          , Hh          , Ww          , Ww          , Ww          , Gs^Fms      , Ww          , Gs          , Gs          , Gs          , Gs          , Gs          , Gs          , Ww          , Gs          , Gs          , Gs          , Gs          , Re          , Ww          , Gs          , Gs          , Ww          , Ww^Vm       , Mm          , Mm          , Mm          , Mm          , Mm          , Mm          
Hh          , Re          , Ww          , Hh          , Hh          , Hh          , Hh          , Hh          , Hh          , Hh          , Hh          , Hh          , Hh          , Hh          , Hh          , Hh          , Mm          , Mm          , Mm^Xm       , Mm^Xm       , Mm          , Ww          , Ww          , Ww          , Ww          , Ww          , Hh          , Hh          , Hh          , Hh^Yc       , Hh          , Hh          , Hh          , Ww          , Hh          , Gs          , Hh          , Ww          , Hh          , Ww          , Ww          , Gs          , Gs          , Gs          , Gs          , Gs          , Gs          , Gs^Yc       , Gs          , Gs          , Re          , Ww          , Gs          , Gs          , Ww          , Hh          , Ww          , Ww          , Mm          , Mm          , Mm          , Wo          
Ww          , Re          , Ww          , Ce          , Ce          , Ce          , Hh          , Hh          , Hh          , Hh          , Hh          , Hh          , Hh          , Hh          , Hh          , Hh          , Hh          , Hh          , Mm^Xm       , Ww          , Ww          , Ww          , Ww          , Ww          , Ww          , Gg^Vc       , Hh          , Hh          , Hh^Yc       , Hh^Yc       , Hh          , Gs          , Hh          , Ww          , Hh          , Hh          , Hh          , Hh          , Hh          , Ww          , Ww^Vm       , Ww          , Gs          , Gs          , Gs          , Gs          , Gs          , Gs^Yc       , Re          , Re          , Gs^Fms      , Ww          , Ww          , Gs^Fms      , Ww          , Ww          , Mm          , Mm          , Mm          , Mm          , Mm          , Mm          
Ww          , Wo^Bw|      , Ww          , Ce          , 1 Ke        , Hh          , Hh          , Hh          , Hh          , Hh          , Hh          , Hh          , Gs^Vht      , Hh          , Hh          , Hh          , Hh          , Hh          , Mm          , Ww          , Ww          , Ww          , Ww          , Ww          , Ww          , Ww          , Hh          , Hh          , Hh          , Gs          , Hh          , Hh          , Gs^Vht      , Hh          , Hh          , Hh          , Hh          , Hh          , Hh          , Hh          , Hh          , Ww          , Ww          , Gs          , Ww          , Gs          , Gs          , Gs^Yc       , Re^Yc       , Gs          , Gs^Fms      , Gs^Fms      , Gs          , Ww          , Hh          , Mm          , Mm          , Mm          , Ww          , Mm          , Mm          , Mm          
Ww          , Hh          , Ce          , Ce          , Hh          , Hh          , Hh          , Hh          , Hh          , Hh          , Hh          , Ww          , Ww          , Hh          , Hh          , Hh          , Hh          , Hh          , Hh          , Hh          , Ww          , Ww          , Ww          , Ww          , Ww          , Ww          , Hh          , Hh          , Gs          , Gs          , Gs          , Hh          , Gs^Fms      , Ww          , Hh          , Hh          , Hh          , Hh          , Hh          , Hh          , Hh          , Hh          , Hh          , Ww          , Gs          , Ww          , Ww          , Gs          , Re          , Gs^Yc       , Gs^Fms      , Gs^Fms      , Gs          , Hh          , Hh          , Mm          , Mm          , Mm          , Mm          , Mm          , Mm          , Mm          
Hh          , Re          , Hh          , Hh          , Hh          , Hh          , Hh          , Hh          , Hh^Vc       , Ww          , Ww          , Ww          , Ww          , Ww          , Hh          , Hh          , Hh          , Hh          , Hh          , Ww          , Ww          , Ww          , Ww          , Ww          , Hh          , Hh          , Ww          , Hh          , Gs^Fms      , Gs^Fms      , Gs^Fms      , Gs^Fms      , Hh          , Ww          , Hh          , Hh^Vhh      , Hh          , Hh          , Hh          , Hh          , Hh          , Hh          , Hh          , Hh          , Gs          , Gs          , Gs          , Ww          , Chw         , Ww          , Ww          , Ww          , Ww          , Ww          , Hh          , Hh          , Hh          , Ww          , Mm          , Mm          , Mm          , Ww          
Ww          , Re          , Re          , Gs          , Gs          , Hh          , Hh          , Hh          , Hh          , Ww          , Ww          , Ww          , Ww          , Ww          , Ww          , Hh          , Hh          , Hh          , Hh          , Hh          , Hh          , Hh^Vhh      , Hh          , Hh          , Hh          , Hh          , Ww          , Ww          , Ww          , Gs^Fms      , Gs^Fms      , Ww          , Ww          , Ww          , Hh          , Hh          , Hh          , Hh          , Hh          , Hh          , Hh          , Hh          , Hh          , Hh          , Hh          , Gs          , Gs          , Re          , Gs          , Gs^Vht      , Gs^Fms      , Ww          , Ww          , Gs^Fms      , Ww          , Hh          , Hh          , Hh          , Hh          , Mm          , Gs          , Ww          
Gs          , Ww          , Gs^Vht      , Re          , Gs          , Gs          , Gs          , Gs          , Gs          , Gs^Fms      , Hh          , Ww          , Ww          , Gg^Vc       , Hh          , Hh          , Hh          , Hh          , Hh          , Hh          , Ww          , Ww          , Hh          , Hh          , Hh          , Ww^Bw\      , Hh          , Ww          , Ww          , Gs^Fms      , Ww          , Ww          , Ww          , Ww          , Hh          , Hh          , Hh          , Hh          , Hh          , Hh          , Hh          , Hh          , Hh          , Hh          , Hh          , Hh^Vc       , Re          , Re          , Gs          , Gs^Fms      , Gs^Fms      , Gs^Fms      , Gs^Fms      , Gs          , Ww          , Ww          , Ww          , Hh          , Hh          , Gs          , Gs          , Gs          
Gs          , Ww          , Gs          , Re          , Gs          , Gs          , Gs          , Gs          , Gs          , Gs^Fms      , Ww          , Ww          , Ww          , Hh          , Hh          , Hh          , Hh          , Gs          , Hh          , Gs          , Hh          , Ww          , Ww          , Ww          , Ww          , Ww          , Re^Uf       , Re^Uf       , Re^Uf       , Ww          , Gs^Fms      , Ww          , Gs^Fms      , Ww          , Hh          , Hh          , Hh          , Hh          , Hh          , Hh          , Hh          , Hh          , Hh          , Hh          , Hh          , Hh          , Re          , Gs          , Gs          , Gs^Fms      , Gs^Fms      , Gs^Fms      , Gs          , Ww          , Ww          , Ww          , Ww          , Ww          , Gs          , Gs          , Gs          , Gs          
Ww          , Ww          , Re          , Re          , Gs          , Gs          , Gs          , Gs          , Ww          , Ww          , Ww          , Ww          , Ww          , Hh          , Hh          , Gs^Fms      , Gs          , Gs^Yc       , Gs^Yc       , Gs^Yc       , Gs^Yc       , Ww          , Ww          , Ww          , Ww          , Ww          , Ww          , Re^Uf       , Re^Uf       , Re^Uf       , Gs          , Ww^Vm       , Gs          , Hh          , Hh          , Hh          , Hh          , Hh          , Hh          , Hh          , Hh          , Hh          , Hh          , Hh          , Hh          , Re          , Hh          , Gs^Fms      , Gs^Fms      , Gs^Fms      , Gs^Fms      , Gs^Fms      , Ww          , Ww          , Re^Uf       , Ww          , Gs          , Gs          , Gs          , Gs          , Gs          , Gs          
Ww          , Ww          , Ww          , Re          , Re          , Gs          , Re          , Gs          , Ww          , Ww          , Gs^Fms      , Ww          , Ww          , Gs^Fms      , Ww          , Gs^Fms      , Ww          , Gs          , Gs          , Gs          , Gs^Yc       , Ww          , Ww          , Ww          , Ww          , Ww          , Gs          , Re^Uf       , Re^Uf       , Re^Uf       , Gs          , Gs^Fms      , Gs          , Hh          , Hh          , Hh          , Hh          , Hh          , Re          , Hh          , Hh          , Hh          , Hh          , Hh          , Hh          , Re          , Gs^Fms      , Gs^Fms      , Gs^Fms      , Gs^Vht      , Gs^Fms      , Gs^Fms      , Ww          , Re^Uf       , Re^Uf       , Ch          , 2 Kh        , Gs          , Gs          , Gs          , Gs          , Gs          
Hh          , Ww          , Ww          , Gs^Vht      , Ww          , Re          , Ww          , Re          , Gs          , Ww          , Ww          , Ww          , Ww          , Ww          , Ww          , Ww          , Ww          , Gs^Vht      , Ww          , Ww          , Ww          , Ww          , Ww          , Ww          , Ww          , Gg^Vc       , Gs          , Gs          , Gs          , Gs          , Gs          , Gs          , Re          , Re          , Re          , Re          , Re          , Re          , Mm          , Re          , Re          , Hh          , Re          , Hh          , Hh^Vhh      , Re          , Gs          , Gs^Fms      , Re          , Gs^Fms      , Ww          , Gs^Fms      , Ww          , Re^Uf       , Ch          , Ch          , Gs          , Gs          , Gs          , Gs          , Ww          , Gs          
Hh          , Gs          , Gs          , Ww          , Gs          , Ww          , Ww          , Ww^Bw|      , Ww          , Ww          , Ww          , Gs          , Gs          , Gs^Fms      , Gs^Fms      , Gs^Fms      , Gs          , Ww          , Gs          , Gs          , Ww          , Ww          , Gs^Fms      , Ww          , Ww          , Gs          , Ww          , Ww          , Ww          , Gs          , Re          , Re          , Hh          , Hh          , Hh          , Hh          , Gg^Vc       , Mm          , Mm          , Mm          , Hh          , Re          , Hh          , Re          , Re          , Re          , Re          , Re          , Ww          , Ww          , Re          , Ww          , Re          , Re^Uf       , Re          , Re          , Gs          , Gs          , Gs          , Gs          , Gs          , Gs          
Hh          , Gs^Fms      , Gs^Fms      , Gs          , Gs          , Ww          , Gs          , Re          , Ww          , Ww^Vm       , Ww          , Gs          , Gs          , Gs          , Gs^Vht      , Gs^Fms      , Gs          , Gs          , Gs          , Gs          , Ww          , Gs          , Ww          , Ww          , Gs          , Gs          , Ww          , Ww          , Gs          , Gs          , Re          , Hh          , Hh          , Hh          , Hh          , Hh          , Mm          , Mm          , Mm          , Mm          , Mm          , Hh          , Hh          , Hh          , Hh          , Re          , Gs^Fms      , Ww          , Gs          , Gs^Fms      , Gs          , Re          , Gs          , Re          , Gs          , Gs^Fms      , Gs^Fms      , Gs^Fms      , Gs^Fms      , Gs          , Gs          , Gs          
Hh          , Gs^Fms      , Gs          , Gs          , Gs          , Gs          , Gs          , Re          , Re          , Ww          , Gs          , Gs          , Gs          , Gs^Fms      , Gs^Fms      , Gs          , Gs          , Gs          , Gs          , Gs          , Ww          , Gs          , Ww          , Ww          , Gs          , Gs          , Ww          , Ww          , Re          , Re          , Hh          , Hh          , Hh          , Hh          , Hh          , Hh          , Mm          , Mm          , Mm          , Mm          , Mm          , Hh          , Hh          , Hh          , Hh          , Re          , Re          , Ww          , Gs^Fms      , Gs^Fms      , Gs^Fms      , Gs^Fms      , Gs^Fms      , Gs^Fms      , Gs^Fms      , Gs^Fms      , Gs^Fms      , Gs^Fms      , Gs^Fms      , Gs^Fms      , Gs^Vht      , Gs          
Hh          , Gs^Fms      , Gs          , Gs          , Gs          , Gs          , Gs          , Gs          , Gs          , Re          , Re          , Gs          , Re          , Re          , Re          , Gs          , Re          , Re          , Re          , Ww          , Ww          , Ww          , Hh          , Hh          , Re          , Re          , Re          , Ww          , Ww          , Hh          , Hh          , Hh          , Hh          , Hh          , Hh          , Mm          , Mm          , Mm          , Mm          , Mm          , Mm          , Hh          , Hh          , Hh          , Hh          , Hh          , Gs          , Ww          , Gs^Fms      , Gs          , Gs          , Gs^Fms      , Gs^Fms      , Gs          , Gs^Fms      , Gs^Fms      , Gs^Fms      , Gs^Fms      , Gs^Fms      , Gs          , Gs^Fms      , Gs^Fms      
