border_size=1
usage=map

Mm          , Mm          , Mm          , Gs          , Gs          , Gs          , Gs          , Gs          , Mm          , Mm          , Gs          , Mm          , Mm          , Mm          , Mm          , Mm          , Mm          , Ww          , Mm          , Mm          , Mm^Xm       , Gs          , Mm^Xm       , Mm^Xm       , Mm^Xm       , Mm^Xm       , Mm          , Mm          , Mm          , Mm          , Gs          , Mm          , Mm          , Gs          , Gs          , Mm          , Gs          , Mm^Xm       , Mm^Xm       , Mm^Xm       , Mm^Xm       , Mm^Xm       , Mm^Xm       , Mm^Xm       , Mm          , Mm          , Mm          , Mm          , Hh          , Hh          , Re          , Hh^Fdf      , Hh^Fdf      , Hh^Fdf      , Hh          , Gs          , Gs          , Gs          , Gs          , Gs          , Gs          , Gs          
Gs          , Mm          , Gs          , Gs          , Gs          , Gs          , Gs          , Hh          , Gs          , Gs          , Gs          , Mm          , Mm          , Mm          , Mm          , Mm          , Mm          , Mm          , Mm^Xm       , Mm^Xm       , Mm^Xm       , Gs          , Gs          , Gs          , Gs          , Mm^Xm       , Mm          , Mm          , Mm          , Gs          , Mm          , Mm          , Mm          , Mm          , Mm          , Mm          , Mm          , Gs          , Gs          , Gs          , Gs          , Mm^Xm       , Mm          , Mm          , Mm^Vhh      , Mm          , Hh^Fdf      , Hh^Fdf      , Hh          , Hh          , Hh^Fdf      , Re          , Hh          , Hh^Fdf      , Hh^Fdf      , Gs          , Hh^Vhh      , Hh          , Hh          , Gs          , Gs          , Gs          
Gs          , Gs          , Gs          , Gs          , Gs          , Gs          , Gs          , Gs          , Mm          , Mm          , Mm          , Mm          , Mm          , Mm          , Mm          , Mm          , Mm          , Mm          , Mm          , Mm          , Mm^Xm       , Mm^Xm       , Mm^Xm       , Gs          , Mm^Xm       , Gs          , Gs          , Mm^Vc       , Gs          , Gs          , Mm          , Mm          , Mm          , Mm          , Mm          , Mm          , Mm          , Mm          , Mm          , Mm          , Gs          , Gs          , Mm          , Mm          , Mm          , Hh^Fdf      , Hh^Fdf      , Hh^Fdf      , Hh^Vc       , Hh          , Hh          , Re          , Re          , Hh          , Hh          , Gs          , Mm          , Gs          , Hh          , Gs          , Gs          , Gs          
Gs          , Mm^Vhh      , Mm          , Gs          , Gs          , Gs          , Gs          , Gs          , Mm          , Mm          , Mm          , Mm          , Mm          , Mm          , Mm          , Mm          , Mm          , Mm^Xm       , Mm^Xm       , Mm^Xm       , Mm^Xm       , Mm^Xm       , Mm^Xm       , Mm^Xm       , Mm^Xm       , Mm^Xm       , Gs          , Gs          , Mm          , Gs          , Mm          , Mm          , Mm          , Mm          , Mm          , Mm          , Mm          , Mm          , Mm          , Mm          , Mm          , Gs          , Mm          , Mm          , Hh^Fdf      , Hh^Fdf      , Hh^Fdf      , Gs          , Gs          , Hh          , Hh          , Hh          , Re          , Hh          , Hh          , Gs          , Mm          , Gs          , Hh^Vhh      , Gs          , Gs          , Gs          
Re          , Mm          , Mm          , Mm          , Mm          , Gs          , Mm^Vhh      , Gs          , Mm          , Mm          , Mm          , Mm          , Mm          , Mm^Xm       , Mm^Xm       , Mm^Xm       , Mm^Xm       , Mm^Xm       , Mm^Xm       , Mm^Xm       , Mm^Xm       , Mm^Xm       , Mm^Xm       , Mm^Xm       , Mm^Xm       , Mm^Xm       , Mm          , Mm          , Mm          , Mm          , Mm          , Mm          , Mm          , Mm          , Mm          , Mm          , Mm          , Mm          , Mm          , Mm          , Mm          , Gs          , Gs          , Gs^Vht      , Gs          , Hh^Fdf      , Gs          , Gs          , Hh          , Gs          , Gs          , Gs          , Re          , Hh          , Mm          , Hh          , Mm          , Mm          , Mm^Xm       , Gs          , Mm^Xm       , Gs          
Re          , Mm          , Gs          , Mm          , Gs          , Gs          , Mm          , Mm          , Mm          , Mm          , Mm          , Mm          , Mm^Xm       , Mm^Xm       , Mm^Xm       , Mm^Xm       , Mm^Xm       , Mm^Xm       , Mm^Xm       , Mm^Xm       , Mm^Xm       , Mm^Xm       , Mm^Xm       , Mm^Xm       , Mm^Xm       , Mm^Xm       , Mm          , Mm          , Mm          , Mm          , Mm^Yc       , Mm^Yc       , Mm          , Mm          , Mm          , Mm          , Gs^Uf       , Mm          , Mm          , Mm          , Mm          , Hh          , Hh          , Gs          , Hh^Fdf      , Gs          , Gs          , Hh          , Hh          , Gs          , Gs          , Gs          , Gs          , Hh          , Gs          , Mm          , Mm^Xm       , Mm^Xm       , Mm^Xm       , Mm^Xm       , Mm^Xm       , Mm^Xm       
Re          , Mm          , Gs          , Gs          , Mm          , Mm          , Mm          , Mm          , Mm          , Mm          , Mm          , Mm          , Mm          , Mm          , Mm^Xm       , Mm          , Mm^Xm       , Mm^Xm       , Mm^Xm       , Mm^Xm       , Mm^Xm       , Mm^Xm       , Mm^Xm       , Mm^Xm       , Mm^Xm       , Mm          , Mm          , Mm          , Mm          , Mm^Yc       , Mm          , Mm          , Mm          , Mm          , Gs          , Gs          , Gs          , Hh^Fdf      , Gs          , Hh          , Hh          , Hh          , Hh          , Hh          , Hh          , Gs          , Hh          , Hh          , Hh          , Hh          , Re          , Gs          , Hh          , Hh          , Gs          , Hh^Vhh      , Mm^Xm       , Mm^Xm       , Mm^Xm       , Mm^Xm       , Mm^Xm       , Mm^Xm       
Mm          , Re          , Gs          , Mm          , Mm          , Mm          , Mm          , Mm          , Mm          , Mm          , Mm          , Mm          , Mm          , Mm          , Mm          , Mm          , Mm^Xm       , Mm^Xm       , Mm^Xm       , Mm^Xm       , Mm^Xm       , Gs          , Gs          , Gs          , Gs          , Gs          , Mm          , Mm          , Mm          , Mm^Yc       , Mm          , Mm          , Mm          , Gs          , Mm          , Hh          , Mm          , Gs          , Mm          , Gs          , Gs          , Hh          , Hh          , Hh          , Hh          , Hh          , Hh          , Hh^Yc       , Hh          , Hh          , Re          , Gs          , Hh          , Hh          , Gs          , Mm          , Gs          , Gs          , Mm^Xm       , Mm^Xm       , Mm^Xm       , Ww          
Gs          , Re          , Gs          , Ce          , Ce          , Ce          , Mm          , Mm          , Mm          , Mm          , Mm          , Mm          , Mm          , Mm          , Mm          , Mm          , Mm          , Mm          , Mm^Xm       , Gs          , Gs          , Gs          , Gs          , Gs          , Gs          , Mm^Vhh      , Mm          , Mm          , Mm^Yc       , Mm^Yc       , Mm          , Hh          , Mm          , Gs          , Mm          , Mm          , Mm          , Mm          , Mm          , Gs          , Gs^Vht      , Gs          , Hh          , Hh          , Hh          , Hh          , Hh          , Hh^Yc       , Re          , Re          , Hh^Fdf      , Gs          , Gs          , Hh^Fdf      , Gs          , Gs          , Mm^Xm       , Mm^Xm       , Mm          , Mm^Xm       , Mm^Xm       , Mm^Xm       
Gs          , Gs          , Gs          , Ce          , 1 Ke        , Mm          , Mm          , Mm          , Mm          , Mm          , Mm          , Mm          , Mm^Vc       , Mm          , Mm          , Mm          , Mm          , Mm          , Mm^Xm       , Gs          , Gs          , Gs          , Gs          , Gs          , Gs          , Gs          , Mm          , Mm          , Mm          , Hh          , Mm          , Mm          , Hh^Vhh      , Gs          , Mm          , Mm          , Mm          , Mm          , Mm          , Mm          , Mm          , Gs          , Gs          , Hh          , Gs          , Hh          , Hh          , Hh^Yc       , Re^Yc       , Gs          , Hh^Fdf      , Hh^Fdf      , Hh          , Gs          , Mm          , Mm          , Mm          , Mm          , Ww          , Mm          , Mm^Xm       , Mm^Xm       
Gs          , Mm          , Ce          , Ce          , Mm          , Mm          , Mm          , Mm          , Mm          , Mm          , Mm          , Gs          , Gs          , Mm          , Mm          , Mm          , Mm          , Mm          , Mm          , Mm          , Gs          , Gs          , Gs          , Gs          , Gs          , Gs          , Gs          , Mm          , Hh          , Hh          , Hh          , Mm          , Hh^Fdf      , Gs          , Mm          , Mm          , Mm          , Mm          , Mm          , Mm          , Mm          , Mm          , Mm          , Gs          , Hh          , Gs          , Gs          , Hh          , Re          , Hh^Yc       , Hh^Fdf      , Hh^Fdf      , Hh          , Mm          , Mm          , Mm          , Mm          , Mm          , Mm          , Mm^Xm       , Mm^Xm       , Mm^Xm       
Mm          , Re          , Mm          , Mm          , Mm          , Mm          , Mm          , Mm          , Mm^Vhh      , Gs          , Gs          , Gs          , Gs          , Gs          , Mm          , Mm          , Mm          , Mm          , Mm          , Gs          , Gs          , Gs          , Gs          , Gs          , Mm          , Mm          , Gs          , Mm          , Hh^Fdf      , Hh^Fdf      , Hh^Fdf      , Hh^Fdf      , Hh          , Gs          , Mm          , Hh^Vhh      , Mm          , Mm          , Mm          , Mm          , Mm          , Mm          , Mm          , Mm          , Hh          , Hh          , Hh          , Gs          , Ch          , Gs          , Gs          , Gs          , Gs          , Gs          , Gs          , Mm          , Mm          , Ww          , Mm^Xm       , Mm^Xm       , Mm^Xm       , Ww          
Gs          , Re          , Re          , Hh          , Hh          , Mm          , Mm          , Mm          , Mm          , Gs          , Gs          , Gs          , Gs          , Gs          , Gs          , Mm          , Mm          , Mm          , Mm          , Mm          , Mm          , Mm^Vhh      , Mm          , Mm          , Mm          , Mm          , Gs          , Gs          , Gs          , Hh^Fdf      , Hh^Fdf      , Gs          , Gs          , Gs          , Mm          , Mm          , Mm          , Mm          , Mm          , Mm          , Mm          , Mm          , Mm          , Mm          , Mm          , Hh          , Hh          , Re          , Hh          , Hh^Vhh      , Hh^Fdf      , Gs          , Gs          , Hh^Fdf      , Gs          , Mm          , Mm          , Mm          , Mm          , Mm^Xm       , Hh          , Ww          
Hh          , Gs          , Hh^Vc       , Re          , Hh          , Hh          , Hh          , Hh          , Hh          , Hh^Fdf      , Mm          , Gs          , Gs          , Mm^Vhh      , Mm          , Mm          , Mm          , Mm          , Mm          , Mm          , Gs          , Gs          , Mm          , Mm          , Mm          , Hh          , Gs          , Gs          , Gs          , Hh^Fdf      , Gs          , Gs          , Gs          , Gs          , Mm          , Mm          , Mm          , Mm          , Mm          , Mm          , Mm          , Mm          , Mm          , Mm          , Mm          , Hh^Vc       , Re          , Re          , Hh          , Hh^Fdf      , Hh^Fdf      , Hh^Fdf      , Hh^Fdf      , Hh          , Gs          , Gs          , Gs          , Mm          , Mm          , Hh          , Hh          , Hh          
Re          , Gs          , Hh          , Re          , Hh          , Hh          , Hh          , Hh          , Hh          , Hh^Fdf      , Gs          , Gs          , Gs          , Mm          , Mm          , Mm          , Mm          , Hh          , Mm          , Hh          , Mm          , Gs          , Gs          , Gs          , Gs          , Gs          , Hh^Uf       , Hh^Uf       , Hh^Uf       , Gs          , Hh^Fdf      , Gs          , Hh^Fdf      , Gs          , Mm          , Mm          , Mm          , Mm          , Mm          , Mm          , Mm          , Mm          , Mm          , Mm          , Mm          , Mm          , Re          , Hh          , Hh          , Hh^Fdf      , Hh^Fdf      , Hh^Fdf      , Hh          , Gs          , Gs          , Gs          , Gs          , Gs          , Hh          , Hh          , Hh          , Hh          
Gs          , Gs          , Re          , Re          , Hh          , Hh          , Hh          , Hh          , Gs          , Gs          , Gs          , Gs          , Gs          , Mm          , Mm          , Hh^Fdf      , Hh          , Hh^Yc       , Hh^Yc       , Hh^Yc       , Hh^Yc       , Gs          , Gs          , Gs          , Gs          , Gs          , Gs          , Hh^Uf       , Hh^Uf       , Hh^Uf       , Hh          , Hh^Vhh      , Hh          , Mm          , Mm          , Mm          , Mm          , Mm          , Mm          , Mm          , Mm          , Mm          , Mm          , Mm          , Mm          , Re          , Mm          , Hh^Fdf      , Hh^Fdf      , Hh^Fdf      , Hh^Fdf      , Hh^Fdf      , Gs          , Gs          , Hh^Uf       , Gs          , Hh          , Hh          , Hh          , Hh          , Hh          , Hh          
Gs          , Gs          , Gs          , Re          , Re          , Hh          , Re          , Hh          , Gs          , Gs          , Hh^Fdf      , Gs          , Gs          , Hh^Fdf      , Gs          , Hh^Fdf      , Gs          , Hh          , Hh          , Hh          , Hh^Yc       , Gs          , Gs          , Gs          , Gs          , Gs          , Hh          , Hh^Uf       , Hh^Uf       , Hh^Uf       , Hh          , Hh^Fdf      , Hh          , Mm          , Mm          , Mm          , Mm          , Mm          , Re          , Mm          , Mm          , Mm          , Mm          , Mm          , Mm          , Re          , Hh^Fdf      , Hh^Fdf      , Hh^Fdf      , Hh^Vhh      , Hh^Fdf      , Hh^Fdf      , Gs          , Hh^Uf       , Hh^Uf       , Ch          , 2 Kh        , Hh          , Hh          , Hh          , Hh          , Hh          
Mm          , Gs          , Gs          , Gs^Vht      , Gs          , Re          , Gs          , Re          , Hh          , Gs          , Gs          , Gs          , Gs          , Gs          , Gs          , Gs          , Gs          , Gg^Vc       , Gs          , Gs          , Gs          , Gs          , Gs          , Gs          , Gs          , Gs^Vht      , Hh          , Hh          , Hh          , Hh          , Hh          , Hh          , Re          , Re          , Re          , Re          , Re          , Re          , Mm^Xm       , Re          , Re          , Mm          , Re          , Mm          , Hh^Vhh      , Re          , Hh          , Hh^Fdf      , Re          , Hh^Fdf      , Gs          , Hh^Fdf      , Gs          , Hh^Uf       , Ch          , Ch          , Hh          , Hh          , Hh          , Hh          , Gs          , Hh          
Mm          , Hh          , Hh          , Gs          , Hh          , Gs          , Gs          , Gs          , Gs          , Gs          , Gs          , Hh          , Hh          , Hh^Fdf      , Hh^Fdf      , Hh^Fdf      , Hh          , Gs          , Hh          , Hh          , Gs          , Gs          , Hh^Fdf      , Gs          , Gs          , Hh          , Gs          , Gs          , Gs          , Hh          , Re          , Re          , Mm          , Mm          , Mm          , Mm          , Mm^Vc       , Mm^Xm       , Mm^Xm       , Mm^Xm       , Mm          , Re          , Mm          , Re          , Re          , Re          , Re          , Re          , Gs          , Gs          , Re          , Gs          , Re          , Hh^Uf       , Re          , Re          , Hh          , Hh          , Hh          , Hh          , Hh          , Hh          
Mm          , Hh^Fdf      , Hh^Fdf      , Hh          , Hh          , Gs          , Hh          , Re          , Gs          , Gs^Vht      , Gs          , Hh          , Hh          , Hh          , Hh^Vhh      , Hh^Fdf      , Hh          , Hh          , Hh          , Hh          , Gs          , Hh          , Gs          , Gs          , Hh          , Hh          , Gs          , Gs          , Hh          , Hh          , Re          , Mm          , Mm          , Mm          , Mm          , Mm          , Mm^Xm       , Mm^Xm       , Mm^Xm       , Mm^Xm       , Mm^Xm       , Mm          , Mm          , Mm          , Mm          , Re          , Hh^Fdf      , Gs          , Hh          , Hh^Fdf      , Hh          , Re          , Hh          , Re          , Hh          , Hh^Fdf      , Hh^Fdf      , Hh^Fdf      , Hh^Fdf      , Hh          , Hh          , Hh          
Mm          , Hh^Fdf      , Hh          , Hh          , Hh          , Hh          , Hh          , Re          , Re          , Gs          , Hh          , Hh          , Hh          , Hh^Fdf      , Hh^Fdf      , Hh          , Hh          , Hh          , Hh          , Hh          , Gs          , Hh          , Gs          , Gs          , Hh          , Hh          , Gs          , Gs          , Re          , Re          , Mm          , Mm          , Mm          , Mm          , Mm          , Mm          , Mm^Xm       , Mm^Xm       , Mm^Xm       , Mm^Xm       , Mm^Xm       , Mm          , Mm          , Mm          , Mm          , Re          , Re          , Gs          , Hh^Fdf      , Hh^Fdf      , Hh^Fdf      , Hh^Fdf      , Hh^Fdf      , Hh^Fdf      , Hh^Fdf      , Hh^Fdf      , Hh^Fdf      , Hh^Fdf      , Hh^Fdf      , Hh^Fdf      , Hh^Vhh      , Hh          
Mm          , Hh^Fdf      , Hh          , Hh          , Hh          , Hh          , Hh          , Hh          , Hh          , Re          , Re          , Hh          , Re          , Re          , Re          , Hh          , Re          , Re          , Re          , Gs          , Gs          , Gs          , Mm          , Mm          , Re          , Re          , Re          , Gs          , Hh          , Mm          , Mm          , Mm          , Mm          , Mm          , Mm          , Mm^Xm       , Mm^Xm       , Mm^Xm       , Mm^Xm       , Mm^Xm       , Mm^Xm       , Mm          , Mm          , Mm          , Mm          , Mm          , Gs          , Gs          , Hh^Fdf      , Hh          , Hh          , Hh^Fdf      , Hh^Fdf      , Hh          , Hh^Fdf      , Hh^Fdf      , Hh^Fdf      , Hh^Fdf      , Hh^Fdf      , Hh          , Gs^Fdw      , Gs^Fdw      
