Gs^Fp, Gs^Fp, Gs^Fp, Gs^Fp, Gg, Gg, Gg, Gg, Gg, Gg, Gg, Gg, Gg, Gg, Gg, Gg, Gg, Gg, Gg, Gg, Gg, Gg, Gg, Gg, Gg, Ds, Ds, Gg, Gg, Gg, Ww, Ww, Gg, Gg, Gg, Gg, Gs^Fp, Gg, Gg, Gg, Gg, Gg, Ds, Ww, Ww, Gg, Gg, Gg, Gg, Gg, Gg, Gg, Gg, Gg, Gg, Gg, Gg
Gs^Fp, Gll^Fmw, Gs^Fp, Gs^Fp, Gg, Gg, Gg, Gg, Gg, Gg, Gg, Gg^Vh, Gg, Gg, Gg, Gg, Gg, Gg, Gg, Gg, Gg, Gg, Gg, Gg, Gg, Ds, Ds, Ds, Gg, Gg, Ww, Ww, Gg, Gg, Gg, Gg, Gs^Fp, Gg, Gg, Gg, Gg^Vh, Gg, Ds, Ww, Ww, Gg, Gg, Gg, Re^Gvs, Gg, Re^Gvs, Gg, Gg, Gg, Gg, Gg, Gg
Gs^Fp, Gs^Fp, Gll^Fmw, Gs^Fp, Gg, Gg, Ce, Gg, Gg, Gg, Gg, Gg, Gg, Gg, Gg, Gs^Fp, Gg, Gg, Gg, Gg, Gg, Ds, Ds, Ds, Ds, Ds, Gg, Gg, Gg, Gg, Ww, Gg, Gg, Gg, Gg, Gg, Gg, Gg, Ss, Gg, Gs^Fp, Gg, Gg, Ds, Ww, Gg, Gg, Re^Gvs, Re^Gvs, Re^Gvs, Re^Gvs, Re^Gvs, Re^Gvs, Re^Gvs, Re^Gvs, Gg, Gg
Gs^Fp, Gs^Fp, Gs^Fp, Gs^Fp, Gg, Ce, 1 Ke, Ce, Gg, Gg, Gg, Gs^Fp, Gll^Fmw, Gs^Fp, Gg, Gg, Gg, Gg, Gg, Gg, Gg, Gg, Gg^Vh, Ds, Gg, Gg, Gg, Gg, Gg, Gg, Ww^Bw/, Gg, Ww^Bw|, Gg, Ds, Gg, Gg, Gs^Fp, Gg, Gs^Fp, Gg, Gg, Gg, Ds, Ww^Bw/, Gg, Gg, Re^Gvs, Re^Gvs, Re^Gvs, Re^Gvs, Re^Gvs, Re^Gvs, Re^Gvs, Re^Gvs, Gg, Gg
Gg, Gg, Gs^Fp, Gs^Fp, Gg, Ce, Ce, Ce, Hh, Gs^Fp, Gs^Fp, Gll^Fmw, Gg, Gs^Fp, Gg, Gs^Fp, Gs^Fp, Gg, Gg, Gg, Gg, Gg, Gg, Gg, Gg, Gg, Gg, Gg, Gg, Gg, Gs^Fp, Ww, Gg, Ww, Gg^Vh, Ww, Gg, Gg, Gs^Fp, Gs^Fp, Gg, Gg, Gg, Gg, Gg, Ww, Ww, Re^Gvs, Re^Gvs, Re^Gvs, Re^Gvs, Re^Gvs, Ce, Re^Gvs, Re^Gvs, Gg, Gg
Hh, Hh, Gs^Fp, Hh^Vhh, Gg, Gg, Mm, Gg, Gg, Gg, Gg, Gg, Gg, Gg, Gs^Fp, Gg, Gg, Gg, Gg, Gg, Gs^Fp, Gg, Gg, Gg, Gg, Gg, Gg, Gg, Gg, Ww, Ww, Ww, Gg, Ww, Ww, Ww, Gg, Gg, Gg, Gg, Gg, Gs^Fp, Gg, Gg, Gg, Ww, Gg, Ww, Gg, Re^Gvs, Re^Gvs, Ce, 2 Ket, Ce, Re^Gvs, Gg, Gg
Hh, Hh, Gg, Gg, Gg, Gg, Gg, Gg, Gg, Gg, Gg, Gg, Gg, Gg, Gg, Gg, Gg, Gs^Fp, Gs^Fp, Gg, Gs^Fp, Gs^Fp, Ss, Gg, Gg, Gg, Gg, Gg, Gg, Ww, Ww, Gg, Gg, Gg, Gg, Gg, Gg, Gg, Gg, Gg, Gs^Fp, Gs^Fp, Gll^Fmw, Gs^Fp, Gg^Vh, Ww, Gg, Gg, Gg, Gg, Gg, Ce, Ce, Ce, Re^Gvs, Gg, Gg
Gg, Gg, Gg, Gg, Gg, Gg, Gg, Gg, Gg, Gg, Gg, Gg, Gg, Gg, Gg, Gg, Gg, Gs^Fp, Gs^Fp, Gg, Gg, Gs^Fp, Gs^Fp, Gg, Gg, Gg, Gg, Gg, Ww, Ww^Bw\, Gg, Gg, Gg, Gg, Gg, Gg, Gg, Gg, Gg, Gg, Gs^Fp, Gll^Fmw, Gs^Fp, Gs^Fp, Gs^Fp, Ww, Gg, Gg, Gg, Hh, Hh, Gg, Gg, Re^Gvs, Gg, Gg, Gg
Gg, Gg, Gg, Gg, Gg, Gg, Gg, Mm, Gg, Gg, Gg, Gg^Vh, Gg, Gg, Gs^Fp, Gg, Gs^Fp, Gg^Ve, Gg, Gg, Gg, Gg, Gs^Fp, Gs^Fp, Gg, Gg, Ww, Ww, Ww, Gg, Gg, Gg, Gg, Gg, Gg, Gg, Gg, Gg, Gg, Gg, Gg, Gg, Gg, Gs^Fp, Gs^Fp, Ww, Gg, Gg, Gg, Hh, Hh, Hh, Gg, Gg, Gg, Gg, Gg
Gg, Gg, Gg, Gg, Gg, Gg, Mm, Mm, Mm, Gg, Gg, Gg, Gg, Gg, Gg, Gg, Gs^Fp, Gs^Fp, Gg, Gg, Gg, Gg, Gg, Gg, Gg, Gg, Gg, Gg, Gg, Gg, Gs^Fp, Gg, Gg, Gg, Gg, Gg, Gg, Gs^Fp, Gs^Fp, Gg, Gg, Gg, Gg, Gg, Gs^Fp, Ww, Gs^Fp, Gs^Fp, Hh, Hh, Mm, Mm, Mm, Mm, Mm, Gg, Gg
Gg, Gg, Gg, Gg, Gg, Gg, Mm, Mm, Mm, Mm, Hh, Gg, Gg, Gg, Gg, Gg, Gg, Gg, Gg, Gg, Gg, Gg, Gg, Gg, Gg, Gg, Gg, Gg, Gg, Gs^Fp, Tb^Tf, Gg, Gg, Gg, Gg, Gg, Gg, Gg, Gg, Gs^Fp, Gs^Fp, Gg, Gg, Gg, Gg, Ww, Gg^Ve, Gs^Fp, Gs^Fp, Hh, Mm, Mm, Mm, Mm, Mm, Mm, Mm
Mm, Mm, Hh, Mm, Gg, Hh, Mm, Mm, Hh, Hh, Gg, Gg, Gg, Gg, Gg, Gg, Gg, Gg, Gg, Gg, Gg, Gg, Gg, Gg, Gg, Gg, Gg, Gg, Gs^Fp, Gs^Fp, Tb^Tf, Gg, Gg, Gg, Gs^Fp, Gg, Gs^Fp, Gg, Gg, Gg, Gg, Gg, Gg, Gg, Gg, Ww, Gs^Fp, Gg, Gg, Hh, Mm, Mm, Mm, Mm, Mm, Mm, Mm
Hh, Hh, Hh, Hh, Hh, Hh, Hh, Hh, Gs^Fp, Gg, Gg, Gg, Gg, Gg, Gg, Gg, Gg, Gg, Gg, Gg, Gg, Gg, Gg, Gg, Gg, Gg, Gg, Gg, Gll^Fmw, Tb^Tf, Tb^Tf, Gg, Gg, Gg, Gg, Gs^Fp, Gg, Gg, Gg, Gg, Gg, Gg, Gg, Gg, Gg, Ww, Gs^Fp, Gg, Gg, Hh, Hh, Hh, Mm, Mm, Mm, Mm, Mm
Hh, Hh, Gg, Hh, Hh, Gs^Fp, Gs^Fp, Gs^Fp, Gs^Fp, Gg, Gg, Gg, Gg, Gg, Gg, Gg, Gg, Gg, Gg, Gg, Gg, Gs^Fp, Gs^Fp, Gs^Fp, Gg, Gg, Gg^Vh, Gg, Gll^Fmw, Gs^Fp, Gs^Fp, Gg, Gg, Gg, Gg, Gg, Gg, Gg, Gg, Gg, Gg, Gg, Gg, Gg, Ds, Ww, Gs^Fp, Gg, Gg, Gs^Fp, Gs^Fp, Gg, Hh, Mm, Hh, Mm, Mm
Gg, Gg, Gg, Gg, Gg, Gs^Fp, Gd^Fetd, Gs^Fp, Gs^Fp, Gg, Gg, Gg, Gg, Gg, Gg, Gg, Gg, Gg, Gg, Gg, Gg^Ve, Gs^Fp, Gg, Gs^Fp, Gs^Fp, Gg, Gg, Gg, Gg, Gg, Gg, Gg, Gg, Gg, Gg, Gg, Gg, Gg, Gg, Gg, Gg^Vh, Gg, Ds, Ds, Ds, Ww, Ss, Gs^Fp, Gs^Fp, Gs^Fp, Gs^Fp, Gg, Gg, Gg, Hh, Hh, Hh
Gg, Gg, Gg, Gg, Gg, Gs^Fp, Gs^Fp, Gs^Fp, Gg^Vh, Gg, Gg, Gg, Gg, Gg, Gg, Gg, Gg, Gg, Gs^Fp, Gs^Fp, Re^Gvs, Gs^Fp, Gs^Fp, Gs^Fp, Gs^Fp, Gg, Gg, Gg, Gg, Gg, Gg, Gg, Gg, Gg^Vh, Gg, Gg, Gg, Gg, Gg, Gg, Gg, Gg, Gg, Ds, Ds, Ww, Ww, Ww, Gg, Gg, Gs^Fp, Gg^Ve, Gg, Gg, Gg, Gg, Gg
Gg, Gg, Gg, Gg, Gg, Gg, Gs^Fp, Gs^Fp, Gg, Gg, Gg, Gg, Gg, Gg, Gg, Gg, Re^Gvs, Re^Gvs, Re^Gvs, Re^Gvs, Re^Gvs, Re^Gvs, Gs^Fp, Gs^Fp, Gs^Fp, Gg, Gg, Gg, Gg, Gg, Gg, Gs^Fp, Gs^Fp, Gs^Fp, Gs^Fp, Gg, Gg, Gg, Gg, Gg, Gg, Gg, Gg, Ds, Ds, Ww^Bw\, Ww^Bw\, Ww, Ww, Ss, Gg, Gs^Fp, Gg, Gg, Gg, Gg, Gg
Gg, Gg, Gg, Gg, Gg, Gg, Gg, Gg, Gg, Gg, Gg, Gg, Gg, Gg, Gg, Gg, Re^Gvs, Re^Gvs, Re^Gvs, Re^Gvs, Re^Gvs, Gs^Fp, Gs^Fp, Gs^Fp, Gs^Fp, Gg, Gg, Gg, Gg, Gg, Gg, Gg, Gg, Gg, Gs^Fp, Gg, Gg, Gg, Gg, Gg, Gg, Gg, Gg, Gg, Ww, Ww, Ww, Ww^Bw\, Ww^Bw\, Ww, Ww, Gs^Fp, Gs^Fp, Gg, Gg, Gg, Gg
Gg, Gg, Gg, Gg, Gs^Fp, Gs^Fp, Gs^Fp, Gs^Fp, Gg, Gg, Ds, Ds, Ds, Gg, Ww^Bw\, Ww, Gg, Gg, Gg, Gg, Gg, Gg, Gg, Gs^Fp, Gg, Gg, Gs^Fp, Gg, Gg, Gg, Re, Gg, Gg, Gg, Gs^Fp, Gg, Gg, Gg, Gg, Gg, Gg, Gg, Gg, Gg, Gg, Ww, Ww, Ww, Ww, Ww^Bw\, Gg, Gg, Gs^Fp, Gs^Fp, Gg, Gg, Gg
Gg, Gg, Gg, Gs^Fp, Gg^Ve, Gs^Fp, Gs^Fp, Gg, Gg, Gg, Ds, Ww, Ww, Ww, Ds, Ds, Gg, Gg, Gg, Gg, Gg, Gg, Gg, Gg, Gg, Gs^Fp, Gg, Gg, Re, Re, Re, Re, Re, Gg, Gg, Gs^Fp, Gg, Gg, Gg, Gg, Gg, Gg, Gg, Gg, Gs^Fp, Ww, Ww, Ww, Gg^Vh, Gg, Gg, Gg, Gg, Gs^Fp, Gg, Gg, Gg
Gg, Gg, Gg, Gs^Fp, Gs^Fp, Gs^Fp, Ss, Gg, Ds, Ds, Ww, Ww, Ww, Ww, Ds, Ds, Gg, Gg, Gg, Gg, Gg, Gg, Gg, Gg, Gg, Gg, Re, Re, Re, Ch, Ch, Ch, Re, Re, Re, Gg, Gg, Gg, Gg, Gg, Gg, Gs^Fp, Gs^Fp, Gs^Fp, Gs^Fp, Ww, Ww, Ww, Gg, Gg, Gg, Gg, Gs^Fp, Gs^Fp, Gg, Gg, Gg
Gg, Gg, Gs^Fp, Gs^Fp, Gs^Fp, Ss, Gs^Fp, Gs^Fp, Ds, Ds, Ww, Ww, Ww, Ds, Gg, Gg, Gg, Gg^Vh, Gg, Gg, Gg, Gg, Gg, Gg, Re, Re, Re, Ch, Ch, Ch, Ww, Ch, Ch, Ch, Re, Re, Re, Gg, Gg, Gg, Gg, Gg, Gs^Fp, Gs^Fp, Gll, Ww, Gs^Fp, Gs^Fp, Tb^Tf, Gg, Gg, Gg, Gs^Fp, Gg, Gg, Gg, Gg
Gs^Fp, Gs^Fp, Gs^Fp, Gs^Fp, Ss, Ss, Gs^Fp, Ds, Ds, Ds, Ww, Wo, Ww, Ds, Gg, Ds, Gg, Gg, Gg, Gg, Gg, Gg, Re, Re, Re, Ch, Ch, Ch, Ww, Ww, Ww, Ww, Ww, Ch, Ch, Ch, Re, Re, Re, Gg, Gg, Gg, Gg, Gs^Fp, Ss, Ww, Gs^Fp, Gs^Fp, Tb^Tf, Tb^Tf, Tb^Tf, Gs^Fp, Gs^Fp, Gg, Gg, Gg, Gg
Gs^Fp, Gs^Fp, Gs^Fp, Ss, Ss, Ss, Gs^Fp, Ds, Ds, Ds, Ww, Wo, Ww, Ds, Gg, Gg, Gg, Gg, Gg, Gg, Gg, Gg, Re, Ch, Ch, Ch, Ww, Ww, Ww, Ww, Kh, Ww, Ww, Ww, Ww, Ch, Ch, Ch, Re, Gg, Gg, Gg, Gg, Gs^Fp, Gs^Fp, Ww, Gs^Fp, Gs^Fp, Gs^Fp, Gs^Fp, Gs^Fp, Gs^Fp, Gs^Fp, Gg, Gg, Gs^Fp, Gs^Fp
Gs^Fp, Gs^Fp, Gs^Fp, Ss, Ss, Gll^Fmw, Gs^Fp, Gg, Ds, Ds, Ds, Ww, Ww, Ds, Gg, Gg, Gg, Gg, Gg, Gg, Gg, Gg, Re, Re, Ch, Ch, Ww, Ww, Kh, Ww, Ch, Ww, Kh, Ww, Ww, Ch, Ch, Re, Re, Gg, Gg, Gg, Ds, Ds, Ds, Ww, Ww, Ww, Gg, Gg, Gs^Fp, Gg, Gg, Gg, Gg, Gs^Fp, Gs^Fp
Gs^Fp, Gs^Fp, Gs^Fp, Gs^Fp, Gs^Fp, Gs^Fp, Gg, Gg, Ds, Ds, Ds, Ww, Ww, Ds, Ds, Gg, Gg, Gg, Gg, Gg, Gg, Gg, Re, Ch, Ch, Ch, Ww, Ww, Ww, Ch, 8 Kh, Ch, Ww, Ww, Ww, Ch, Ch, Ch, Re, Gg, Ds, Ds, Ds, Ds, Ds, Gg, Re^Gvs, Ww^Bw/, Ww, Gg, Gg, Gg, Gg, Gg, Gg, Gs^Fp, Gs^Fp
Gs^Fp, Gs^Fp, Gs^Fp, Gg, Gg, Gg, Gg, Gg, Ds, Ds, Ds, Ww, Ww, Ds, Ds, Gg, Gg, Gg, Gg, Gg, Gg, Gg, Re, Re, Ch, Ch, Ww, Ww, Kh, Ch, Ch, Ch, Kh, Ww, Ww, Ch, Ch, Re, Re, Gg, Gs^Fp, Gs^Fp, Gg, Gg, Gg, Gg, Re^Gvs, Gg^Vh, Ww, Gg, Gg, Gg, Gg, Gg, Gg, Gg, Gg
Gs^Fp, Gs^Fp, Gs^Fp, Gg, Gg, Gg, Gg, Gg, Gg, Gg, Ds, Ww, Ww, Ds, Ds, Ds, Gg, Gg, Gg, Gg, Gg, Gg, Re, Ch, Ch, Ch, Ww, Ww, Ww, Ww, Kh, Ww, Ww, Ww, Ww, Ch, Ch, Ch, Re, Gg, Ss, Gs^Fp, Gg, Gg, Gg, Gg, Gg, Re^Gvs, Ww, Ww, Ww, Ww, Gg^Vh, Gg, Ww, Gg, Gg
Gs^Fp, Gs^Fp, Gll^Fmw, Gg^Ve, Gs^Fp, Gg, Gg, Gg, Gg, Ds, Ds, Ww, Wo^Bw/, Ww^Bw/, Ds, Ds, Ds, Gg, Gg, Gg, Gg, Gg, Re, Re, Ch, Ch, Ch, Ww, Ww, Ww, Ww^Bw|, Ww, Ww, Ww, Ch, Ch, Ch, Re, Re, Gg, Gs^Fp, Gg, Gg, Gg, Gg, Gg, Gg, Gg, Gg, Ww, Ww, Ww, Ww, Ww, Ww, Ww, Ww
Gs^Fp, Gs^Fp, Gll^Fmw, Gs^Fp, Gg, Gg, Ch, Ch, Ch, Ds, Ds, Ww^Bw/, Wo, Ww, Ww, Ds, Ds, Ds, Gg, Gg, Gg, Gg, Re, Ch, Re, Ch, Ch, Ch, Ch, Ww, Rr, Ww, Ch, Ch, Ch, Ch, Re, Ch, Re, Gg, Gg, Gg, Gg, Gg, Gg, Gg, Gg, Gg, Chr, Gg, Gg, Ww, Ww, Gg, Ds, Ww, Ww
Gs^Fp, Gs^Fp, Gll^Fmw, Gs^Fp, Gg, Gg, Ch, 7 Kh, Ch, Gg^Vh, Gg, Ds, Ds, Ww, Ww, Ww, Ds, Ds, Ds, Gg, Gg, Gg, Gg, Re, Re, Ch, Re, Ch, Ch, Ch, Rr, Ch, Ch, Ch, Re, Ch, Re, Re, Gg, Gg, Gg, Gg, Gg, Gg, Gg, Gg, Gg, Chr, Khr, Chr, Gg, Ds, Gg, Ds, Ds, Ww, Ww
Gg, Gg, Gg, Gg, Gs^Fp, Gg, Gg, Ch, Gg, Gg, Gg, Gg, Gg, Ds, Ww, Ww, Ww, Ds, Ds, Ds, Ds, Gg, Gg, Gg, Gg, Re, Re, Ch, Ch, Ch, Rr, Ch, Ch, Ch, Re, Re, Gg, Gg, Gg, Gg, Gg, Gg, Gg, Gg, Gg, Gg, Gg, Chr, Chr, Chr, Gg, Gg, Gg, Ds, Ds, Ww, Ww
Gg, Gg, Gg, Gg, Gs^Fp, Gg, Gg, Gg, Gg, Gg, Gg, Gg, Gg, Gg, Ds, Ds, Ww, Wo, Ww, Ds, Ds, Gg, Gg^Vh, Gg, Gg, Gg, Gg, Re, Ch, Rr, Ch, Rr, Ch, Re, Gg, Gg, Gg, Gg, Gg, Gg, Gg, Gg, Gg, Hh, Gg, Gg, Gg, Gg, Gg, Gg, Gg, Gg, Ds, Gg, Ww, Wo, Ww
Gg, Gg, Gg, Gg, Gg, Gs^Fp, Gs^Fp, Gs^Fp, Gg, Gg, Gg, Gg, Gg, Gg, Gg, Ds, Ds, Ww, Ww, Ds, Ds, Gg, Gg, Gg, Gg, Gg, Gg, Re, Re, Rr, Ch, Rr, Re, Re, Gg, Gg, Gg, Gg, Gg, Gg, Gg, Gg, Hh, Hh, Gg, Gg, Gg, Gg, Gg, Gg, Gs^Fp, Ds, Dd^Dr, Ds, Ds, Wo, Wo
Gg, Gg, Gg, Gg, Gg, Gs^Fp, Gg^Ve, Gs^Fp, Gg, Gg, Gg, Gg, Gg, Gg, Gg, Ds, Ds, Ww, Ww, Ww, Ds, Gg, Gg, Gg, Gg, Gg, Gg, Gg, Gg, Re, Re, Re, Gg, Gg, Gg, Gg, Gg, Gs^Fp, Gg, Gg, Gg, Gg, Hh, Hh, Gg, Gg, Gg, Gg, Gg, Gg, Gg, Gs^Fp, Ds, Ds, Ds, Ds, Ds
Gg, Gg, Gg, Gg, Gs^Fp, Gs^Fp, Gs^Fp, Gs^Fp, Gg, Gg, Gg, Gg, Gs^Fp, Gg, Gg, Gg, Gg, Ds, Ww, Ww, Ds, Gg, Gg, Gg, Gg, Gg, Gg, Gg, Hh, Gg, Gg, Gg, Gg, Gg, Gg, Gg, Gg, Gg, Gg, Gs^Fp, Gs^Fp, Gs^Fp, Hh, Hh, Hh, Gg, Gg, Gg, Gg, Gg, Gg, Gg, Gg, Gg, Ds, Ds, Ds
Gg, Gg, Gg, Gs^Fp, Gg, Gll^Fmw, Gll^Fmw, Gs^Fp, Gg, Gg, Gg, Gg, Gg^Ve, Gs^Fp, Gg, Gg, Gg, Gg, Ww, Ww, Ds, Gg, Gg, Gg, Gg, Gg, Gg, Gg, Gg, Gg, Gg, Gg, Gg, Gg, Gg, Gs^Fp, Gs^Fp, Gg, Gg, Gs^Fp, Gg^Ve, Gg, Gs^Fp, Hh, Hh, Hh, Hh, Gg, Gg, Gg, Gg, Gg, Gg, Gg, Gs^Fp, Ds, Ds
Gg, Gg, Hh, Hh, Hh, Gs^Fp, Hh, Gll^Fmw, Gg, Gg, Gg, Gg, Gs^Fp, Gs^Fp, Gs^Fp, Gg, Gg, Gg, Ww, Ds, Ds, Gg, Gg, Gg, Gg, Gg, Gg, Gg, Gg, Gg, Gg, Gg, Gg, Gs^Fp, Gg^Ve, Gs^Fp, Gs^Fp, Gg, Gg, Gs^Fp, Gg, Gg, Gg, Hh, Hh, Hh, Hh, Gg, Hh, Gg, Gg, Gg, Gg, Gg, Gg, Gs^Fp, Gs^Fp
Hh, Hh, Hh, Hh, Hh, Hh, Hh, Hh, Gg, Gg, Gg, Gg, Gs^Fp, Gs^Fp, Gg, Gg, Gg, Gg, Ww, Gg, Gg, Gg, Gg, Gg, Gg, Gg, Gs^Fp, Gg, Gg, Gg, Gg, Gg, Gg, Gs^Fp, Gs^Fp, Gs^Fp, Ds, Gg, Gg, Gs^Fp, Gg, Gg, Gg, Gg, Hh, Hh, Hh, Gg, Hh, Gg, Gg, Gg, Gg, Gg, Gg, Gg^Ve, Gg
Hh, Hh, Hh, Hh^Vhh, Hh, Hh, Hh, Hh, Gg, Gg, Gg, Gg, Gs^Fp, Gs^Fp, Gs^Fp, Gg, Gg, Gg, Ww, Gg, Gg, Gg, Gg, Gg, Gs^Fp, Hh, Gs^Fp, Gs^Fp, Gs^Fp, Gg, Gg, Gg, Gs^Fp, Gs^Fp, Gs^Fp, Ds, Ds, Ds, Gg, Gs^Fp, Gg, Gg, Gg, Gg, Gs^Fp, Hh, Hh, Gg, Gg, Gg, Gs^Fp, Gs^Fp, Gs^Fp, Gs^Fp, Gg, Gs^Fp, Gs^Fp
Hh, Hh, Hh, Hh, Hh, Mm, Hh, Hh, Hh, Gg, Gg, Gg, Gs^Fp, Gs^Fp, Gs^Fp, Gg, Gg, Gg, Ww^Bw/, Gg, Gg, Gg, Gg^Vh, Gg, Gs^Fp, Gg, Hh, Gs^Fp, Gs^Fp, Gg, Gg, Gs^Fp, Gs^Fp, Gll^Fmw, Gs^Fp, Ds, Ds, Ds, Gg, Gg, Gs^Fp, Gs^Fp, Gs^Fp, Gg, Gll^Fmw, Gg, Gg, Gg, Gg, Gg, Gs^Fp, Re^Gvs, Re^Gvs, Gs^Fp, Gs^Fp, Gs^Fp, Gs^Fp
Hh, Hh, Hh, Hh, Hh, Mm, Mm, Mm, Hh, Hh, Gg, Gg, Gg^Ve, Gs^Fp, Gs^Fp, Gs^Fp, Gg, Gg, Gg, Ww, Gg, Gg, Gg, Gs^Fp, Gg, Gg, Gg, Gs^Fp, Gs^Fp, Gs^Fp, Gs^Fp, Gs^Fp, Gs^Fp, Ds, Ds, Ds, Ds, Ds, Gg, Gg, Gg, Gg, Gg, Gs^Fp, Gs^Fp, Gg, Gg, Gg, Gg, Gg, Gs^Fp, Re^Gvs, Re^Gvs, Gs^Fp, Gs^Fp, Gg, Gg
Gs^Fp, Gs^Fp, Hh, Hh, Hh, Hh, Mm, Mm, Hh, Hh, Gg, Gg, Gs^Fp, Gs^Fp, Gs^Fp, Gs^Fp, Gg, Gg, Re^Gvs, Re^Gvs, Re^Gvs, Gg, Gg, Gs^Fp, Gg, Gg, Gs^Fp, Gs^Fp, Gg^Ve, Gs^Fp, Gs^Fp, Gs^Fp, Ds, Ds, Ds, Ds, Dd^Dc, Ds, Ds, Gg, Gg, Gg, Gg, Gg, Gg, Gg, Re, Gg^Vh, Re, Gg, Gg, Gs^Fp, Re, Re, Re, Gs^Fp, Gs^Fp
Gg, Gg, Gg, Hh, Hh, Hh, Hh, Hh, Mm, Hh, Hh, Gg, Gg, Gs^Fp, Gs^Fp, Gg, Gg, Gg, Re^Gvs, Re^Gvs, Re^Gvs, Re^Gvs, Gg, Gs^Fp, Gg, Gs^Fp, Gs^Fp, Gs^Fp, Gs^Fp, Gs^Fp, Gs^Fp, Ds, Ds, Ds, Ds, Ds, Ds, Ds, Ds, Gg, Gg, Gg, Re, Gg, Re, Re, Gg, Re, Gg, Re, Re, Re, Gs^Fp, Gs^Fp, Gs^Fp, Re, Re
Gs^Fp, Gs^Fp, Hh, Hh, Hh, Hh, Hh, Hh, Mm, Mm, Mm, Hh, Gg, Gs^Fp, Gg, Gg, Gg, Re^Gvs, Re^Gvs, Re^Gvs, Re^Gvs, Re^Gvs, Gg, Gg, Gs^Fp, Gs^Fp, Gs^Fp, Gs^Fp, Gs^Fp, Gs^Fp, Gg, Ds, Ds, Ds, Ds, Ds, Ds, Gg, Re, Re, Gg^Vh, Re, Re, Re, Gg, Gg, Gg, Gg, Gg, Gg, Gg, Gs^Fp, Gs^Fp, Gg^Ve, Gs^Fp, Gs^Fp, Gs^Fp
Gs^Fp, Gs^Fp, Gs^Fp, Hh, Hh, Hh, Hh, Mm, Hh, Mm, Mm, Hh, Hh, Gg, Gg, Gg, Gg, Re^Gvs, Re^Gvs, Re^Gvs, Re^Gvs, Re^Gvs, Gg, Gg, Gg, Gg, Gs^Fp, Gs^Fp, Gs^Fp, Gg, Gg, Gg, Ds, Ds, Ds, Ds, Ds, Re, Gg, Gg, Gg, Gg, Gg, Gg, Gg, Gg, Gg, Gg, Gg, Gg, Gg, Gg, Gs^Fp, Gs^Fp, Gs^Fp, Gs^Fp, Gs^Fp
Gs^Fp, Gs^Fp, Gg, Gg, Gg, Gs^Fp, Gg, Hh, Hh, Hh, Hh, Hh, Hh, Hh, Gg, Gg, Gg, Gg, Gg, Gg, Gg, Gg, Gg, Gg, Gg, Gg, Gs^Fp, Gg, Gs^Fp, Gg, Gg, Gs^Fp, Ds, Ds, Ds, Ds, Re, Re, Gg, Gg, Gg, Gg, Ds, Ds, Ds, Ds, Ds, Ds, Ce, Gg, Gg, Gg, Gll^Fmw, Gs^Fp, Gll^Fmw, Gs^Fp, Gs^Fp
Gg, Gg, Gg, Gg, Gg, Gg, Gg, Hh, Hh, Hh, Mm, Mm, Mm, Hh, Hh, Gg, Gg, Gg, Gg, Gg, Gg, Gg, Gg, Gg, Gs^Fp, Gg, Gs^Fp, Gs^Fp, Re, Gs^Fp, Re, Re, Re, Ds, Re, Re, Ds, Gg, Gg, Gs^Fp, Gs^Fp, Gg, Ds, Ds, Ds, Ds, Ds, Ce, 4 Ket, Ce, Gg, Gg, Gs^Fp, Gs^Fp, Gs^Fp, Gs^Fp, Gs^Fp
Gg, Gg, Gg, Gg, Gg, Gs^Fp, Gg, Gg, Hh, Hh, Mm, Mm, Mm, Mm, Hh, Hh, Gg^Vh, Gg, Gg, Gg, Gg, Gg, Gg, Gg, Gg, Gg, Re, Re, Gg^Ve, Re, Gs^Fp, Ds, Ds, Re, Ds, Ds, Gg, Gg, Gs^Fp, Gs^Fp, Gs^Fp, Gg, Gg, Gg, Ds, Ds, Ds, Ce, Ce, Ce, Gg, Gg, Gg, Gg, Gs^Fp, Gg, Gg
Gg, Gg, Gs^Fp, Gs^Fp, Gg^Ve, Gs^Fp, Gg, Gg, Hh, Hh, Mm, Mm, Mm, Mm, Mm, Hh, Gg, Gg, Gg, Gg, Gg, Gg, Gg, Gg, Gg, Gg, Re, Gs^Fp, Gs^Fp, Gs^Fp, Ds, Ds, Ds, Ds, Ds, Gs^Fp, Gs^Fp, Gs^Fp, Gs^Fp, Gg, Gg, Gg, Gg, Gg, Gg, Ds, Ds, Gg, Gg, Gg, Gg, Gg, Gg, Gg, Gg^Ve, Gs^Fp, Gs^Fp
Gs^Fp, Gs^Fp, Gs^Fp, Gs^Fp, Gs^Fp, Gg, Gg, Gg, Gg, Hh, Mm, Mm, Mm, Mm, Mm, Hh, Hh, Gg, Gg, Gg, Gg, Gg, Gg, Gg, Re, Re, Gg, Gs^Fp, Gs^Fp, Ds, Ds, Ds, Ds, Ds, Ds, Gs^Fp, Gg, Gs^Fp, Gg, Gg, Gg, Gg, Gg, Gg, Gg, Gg, Gg, Gg, Gg, Gg, Gg, Gg, Gg, Gg, Gs^Fp, Gs^Fp, Gs^Fp
Gg, Gg, Gg, Gs^Fp, Gg, Gg, Gg, Gg, Gg, Gg, Hh, Mm, Mm, Mm, Mm, Mm, Hh, Hh, Gg, Gg, Gg, Gg, Re, Re, Gg, Gg, Gs^Fp, Gg, Ds, Ds, Ce, Ds, Ds, Ds, Gs^Fp, Gs^Fp, Gg, Gs^Fp, Gs^Fp, Gs^Fp, Gg, Gg, Gg, Gg, Gg, Gg, Gg, Gg, Gg^Vh, Gg, Gg, Gg, Gg, Gg, Gg, Gg, Gg
Gg, Gg, Gs^Fp, Gg, Gg, Gg, Gg, Gg, Gg, Gg, Gg, Mm, Mm, Mm, Mm, Mm, Hh, Hh, Gg, Gg, Gg, Gg, Re, Gg^Vh, Gg, Gg, Gg, Gg, Ds, Ce, Ce, Ce, Ds, Ds, Ss, Gs^Fp, Gs^Fp, Gg, Gg, Gg^Ve, Gg, Gg, Gg, Gg, Gg, Gg, Gg, Gg, Gg, Gg, Gg, Gg, Gg, Gs^Fp, Gs^Fp, Gs^Fp, Gs^Fp
Gs^Fp, Gs^Fp, Gg, Gg, Gg, Gg, Gs^Fp, Gg, Gg, Gg, Gg, Mm, Mm, Mm, Mm, Mm, Hh, Gg, Gg, Gg, Re, Re, Gg, Gg, Gg, Gg, Gg, Gg, Ds, Ce, 6 Ket, Ce, Ds, Ss, Ss, Gg, Gs^Fp, Gg, Gg, Gs^Fp, Gg, Gg, Gg, Gg, Gg, Gg, Gg, Gg, Gg, Gg, Gg, Gg, Gs^Fp, Gs^Fp, Gs^Fp, Gs^Fp, Gs^Fp
Gs^Fp, Gs^Fp, Gg, Gg, Gs^Fp, Gs^Fp, Gll^Fmw, Gg^Efm, Gs^Fp, Gs^Fp, Gg, Gg, Mm, Mm, Mm, Hh, Gg, Gg, Re, Re, Gg, Gg, Gg, Gg, Gg, Gg, Gg, Gg^Vh, Ds, Ce, Ce, Ce, Ds, Ss, Ss, Gg, Gg, Gs^Fp, Gs^Fp, Gs^Fp, Gg, Gg, Gg, Gg, Gg, Gg, Gg, Gg, Gg, Gg, Gg, Gg, Gg, Gs^Fp, Gg, Gs^Fp, Gs^Fp
Gg, Gg, Gg, Gg, Re, Gg, Gg, Gg, Gg, Gg, Gg, Gg, Gg, Hh, Hh, Hh, Gg, Gg, Re, Gg, Gg, Gg, Gg, Gg, Gg, Gg, Gg, Gs^Fp, Gs^Fp, Ds, Ds, Ds, Ds, Ss, Ss, Gg, Gg, Gs^Fp, Gs^Fp, Gg, Gg, Gg, Gg, Gg, Gg, Gg, Gg, Gg, Gg, Gg, Gg^Vh, Gg, Gg, Gg, Gg, Gg, Gg
Gg, Gg, Gg, Gg, Gg, Gg, Gg, Gg, Gg, Gg, Gg, Gg, Gg, Hh, Hh, Gg, Gg, Gg, Re, Gg, Gg, Gg, Gg, Gg, Gg, Gg, Gg, Gs^Fp, Gs^Fp, Ds, Ds, Ds, Ds, Ds, Gg, Gg, Gg, Gs^Fp, Gs^Fp, Gg, Gg, Gg, Gg, Gg, Gg, Gg, Gg, Gg, Gg, Gg, Gg, Gg, Gg, Gg, Gg, Gg, Gg
