Mm, Mm, Mm, Mm, Mm, Mm, Mm, Hh, Hh, Gs, Gs, Gs, Gs, Gs, Gs, Gs, Gs, Gs, Gs, Gs, Gs, Gs, Gs^Ft, Gs, Gs, Ww, Ww, Ww, Ww, Ww, Ww, Ww, Gs, Ww, Ww, Ww, Ww, Ww, Ww, Ww, Gs, Rr, Qlf, Rr, Qlf, Rr, Rr, Rr, Gs, Gs, Gs, Gs
Mm, Mm, Mm, Mm, Mm, Mm, Mm, Hh, Hh, Gs, Gs, Gs, Gs, Gs, Gs, Gs, Gs, Gs, Gs, Gs, Qlf, Qlf, Qlf, Gs, Qlf, Qlf, Ww, Ww, Ww, Gs^Ft, Ww, Ww, Gs^Vc, Ww, Ww, Ww, Ww, Qlf, Ww, Qlf, Qlf, Gs, Qlf, Qlf, Gs, Gs, Rr, Rr, Gs, Gs, Gs, Gs
Mm, Mm, Mm, Mm, Mm, Mm, Mm, Hh, Hh, Gs, Gs, Gs^Vd, Gs, Gs, Gs, Gs, Gs, Gs, Gs, Qlf, Qlf, Qlf, Qlf, Gs, Gs, Qlf, Gs, Ww, Ww, Gs, Gs, Ww, Ww, Ww, Ww, Gs, Qlf, Ww, Qlf, Qlf, Qlf, Qlf, Qlf, Gs^Vd, Rr, Rr, Gs, Rr, Gs, Gs, Gs^Ft, Gs
Mm, Mm, Mm, Mm, Mm, Mm, Mm, Hh, Hh, Gs, Gs, Gs, Gs, Gs, Gs, Gs, Gs^Ft, Gs^Ft, Gs, Qlf, Qlf, Qlf, Qlf, Gs^Ft, Qlf, Qlf, Gs, Ww, Gs, Ww, Ww, Ww, Ww, Gs, Qlf, Qlf, Qlf, Qlf, Qlf, Qlf, Qlf, Qlf, Gs, Gs, Rr, Gs, Gs^Ft, Gs, Gs, Gs^Ft, Gs, Gs^Ft
Mm, Mm, Mm, Mm, Mm, Mm, Mm, Hh, Hh, Hh, Gs, Gs, Gs^Ft, Gs, Gs, Gs, Gs^Ft, Gs, Gs^Ft, Qlf, Qlf, Qlf, Qlf, Qlf, Qlf, Qlf, Gs, Ww, Ww, Ww, Ww, Ww, Qlf, Qlf, Qlf, Qlf, Qlf, Qlf, Qlf, Qlf, Qlf, Gs, Qlf, Qlf, Rr, Gs, Gs^Ft, Gs^Ft, Gs, Gs, Gs^Ft, Gs^Ft
Mm, Mm, Mm, Mm, Mm, Mm, Mm, Gs, Hh, Hh, Gs, Gs, Gs^Ft, Gs^Ft, Gs^Ft, Gs, Gs^Ft, Gs^Ft, Gs^Ft, Qlf, Qlf, Qlf, Qlf, Qlf, Qlf, Qlf, Ww, Ww, Ww, Ww, Ww, Qlf, Qlf, Qlf, Qlf, Qlf, Qlf, Qlf, Qlf, Gs, Hh, Hh, Hh, Gs, Rr, Gs, Gs, Gs, Gs, Gs^Ft, Gs^Ft, Gs^Ft
Mm, Mm, Mm, Mm, Mm, Mm, Mm, Hh, Hh, Gs, Gs, Gs^Ft, Gs, Gs, Gs^Ft, Gs^Ft, Gs, Gs, Gs^Ft, Gs^Ft, Qlf, Gs^Ft, Qlf, Qlf, Qlf, Qlf, Gs, Ww, Gs, Ww, Ww, Qlf, Qlf, Qlf, Qlf, Qlf, Qlf, Qlf, Qlf, Qlf, Qlf, Hh, Mm, Mm, Gs, Rr, Gs, 3 Gs, Gs, Gs^Ft, Gs^Ft, Gs
Hh, Mm, Mm, Mm, Mm, Mm, Mm, Hh, Hh, Gs, Gs, Gs^Ft, Gs^Ft, Gs, Gs, Gs^Ft, Gs, Gs, Gs^Ft, Qlf, Qlf, Qlf, Gs, Qlf, Gs, Qlf, Gs, Ww, Gs, Ww, Ww, Qlf, Qlf, Qlf, Qlf, Qlf, Qlf, Qlf, Qlf, Qlf, Hh, Mm, Mm, Mm, Gs, Rr, Gs, Gs, Gs, Gs, Gs, Gs
Hh, Hh, Mm, Mm, Hh, Mm, Hh, Hh, Hh, Hh, Gs, Gs, Gs, Gs, Gs^Ft, Gs^Ft, Gs, Gs^Ft, Gs, Qlf, Qlf, Gs^Ft, Qlf, Qlf, Gs^Ft, Qlf, Gs^Vd, Gs, Gs, Gs, Gs, Gs, Gs, Qlf, Qlf, Qlf, Qlf, Qlf, Qlf, Gs^Ft, Hh, Mm, Hh, Hh, Gs, Rr, Gs, Gs, Hh, Gs, Gs^Ft, Gs
Hh, Hh, Hh, Hh, Mm, Mm, Hh, Hh, Hh, Gs, Gs, Gs, Gs, Gs, Gs^Ft, Gs^Ft, Gs^Ft, Gs^Ft, Gs^Ft, Qlf, Qlf, Qlf, Gs^Ft, Qlf, Qlf, Gs^Ft, Gs, Gs, Gs, Gs, Gs, Qlf, Gs, Gs, Qlf, Qlf, Qlf, Qlf, Gs^Ft, Gs^Ft, Hh^Ft, Gs^Ft, Hh^Ft, Hh, Gs, Rr, Gs, Gs, Hh, Hh, Gs, Gs
Gs, Hh, Hh, Gs, Gs, Gs, Gs, Gs, Gs, Gs^Vc, Gs, Gs, Gs^Ft, Gs^Ft, Gs^Ft, Gs^Ft, Gs^Ft, Gs, Gs^Ft, Qlf, Gs, Qlf, Qlf, Qlf, Gs^Ft, Qlf, Gs, Mm, Mm, Mm, Hh, Gs, Qlf, Qlf, Qlf, Qlf, Qlf, Qlf, Gs^Ft, Gs^Ft, Gs^Ft, Hh^Ft, Gs^Ft, Hh^Ft, Gs, Rr, Gs, Hh, Hh, Hh, Mm, Gs
Gs, Gs, Hh, Hh, Gs, Gs, Gs, Gs, Gs, Gs, Gs, Gs, Gs^Ft, Gs, Gs^Ft, Gs^Ft, Gs, Gs^Ft, Qlf, Gs, Qlf, Qlf, Qlf, Qlf, Gs, Qlf, Gs, Hh, Hh, Hh, Gs, Mm, Gs, Qlf, Qlf, Gs^Ft, Qlf, Qlf, Gs^Ft, Gs^Ft, Gs^Ft, Hh^Ft, Gs^Ft, Gs, Gs, Rr, Rr, Gs, Hh, Hh, Hh, Mm
Qlf, Gs, Hh, Hh, Hh, Hh, Hh, Hh, Gs, Gs, Gs, Gs, Gs^Ft, Gs^Ft, Gs, Gs, Gs, Gs, Qlf, Gs, Gs, Qlf, Qlf, Qlf, Gs, Gs, Gs, Gs, Gs, Gs, Gs, Qlf, Qlf, Qlf, Qlf, Qlf, Qlf, Gs, Gs, Gs, Gs, Gs^Ft, Gs^Ft, Gs, Gs^Vd, Gs, Rr, Rr, Rr, Hh, Rr, Gs
Qlf, Qlf, Qlf, Qlf, Hh, Hh, Hh, Gs, Gs, Gs, Gs, Gs, Gs^Ft, Gs, Gs, Gs, Gs, Gs, Qlf, Qlf, Qlf, Qlf, Qlf, Qlf, Hhd, Qlf, Hhd, Gs, Hhd, Gs, Qlf, Qlf, Qlf, Qlf, Qlf, Qlf, Gs^Vd, Gs, Gs, Gs, Gs, Gs^Ft, Gs^Ft, Gs, Gs, Gs, Rr, Gs^Ft, Gs^Ft, Rr, Gs, Rr
Qlf, Qlf, Qlf, Qlf, Qlf, Qlf, Hh, Gs, Gs, Gs, Gs, Gs, Gs, Gs, Gs, Gs, Hhd, Gs, Qlf, Hhd, Hhd, Qlf, Qlf, Hhd, Qlf, Hhd, Hhd, Hhd, Hhd, Hhd, Qlf, Qlf, Qlf, Qlf, Hhd, Qlf, Gs, Gs, Gs, Gs, Gs, Gs^Ft, Gs^Ft, Gs, Gs, Rr, Gs, Gs, Gs, Gs, Ss, Rr
Qlf, Qlf, Gs, Qlf, Qlf, Qlf, Qlf, Qlf, 2 Qlf, Qlf, Gs, Gs, Gs, Gs, Hhd, Hhd^Vc, Hhd, Hhd, Hhd, Hhd, Qlf, Qlf, Hhd, Qlf, Hhd, Hhd, Hhd, Hhd, Hhd, Qlf, Qlf, Qlf, Qlf, Qlf, Qlf, Gs, Gs, Gs, Gs, Gs, Gs, Gs, Gs, Gs, Gs, Rr, Gs, Gs, Gs, Ss, Ss, Ss
Gs, Qlf, Qlf, Qlf, Qlf, Qlf, Gs, Qlf, Gs, Qlf, Qlf, Gs, Qlf, Hhd, Hhd, Hhd, Hhd, Hhd, Qlf, Hhd, Hhd, Qlf, Qlf, Hhd, Qlf, Hhd, Hhd, Hhd, Qlf, Qlf, Qlf, Qlf, Qlf, Qlf, Qlf, Hhd, Hhd, Gs, Gs, Gs, Gs, Gs, Gs, Gs, Gs, Rr, Gs, Gs^Ft, Ss, Qlf, Ss, Ss
Gs, Gs, Qlf, Gs, Qlf, Gs, Qlf, Qlf, Qlf, Gs, Gs, Qlf, Qlf, Hhd, Qlf, Hhd, Hhd, Hhd, Md, Md, Qlf, Qlf, Qlf, Md, Md^Xm, Md, Md, Md, Md, Qlf, Md, Qlf, Qlf, Qlf, Hhd, Hhd, Hhd, Hh, Hhd, Gs, Gs, Gs, Gs, Gs, Gs, Rr, Qlf, Gs^Ft, Ss, Qlf, Ss, Ss
Gs, Gs, Gs, Gs, Gs^Ft, Gs^Ft, Qlf, Qlf, Qlf, Gs, Qlf, Gs, Qlf, Qlf, Qlf, Hhd, Qlf, Md, Md, Qlf, Qlf, Qlf, Qlf, Qlf, Qlf, Md^Xm, Md^Xm, Md^Xm, Qlf, Qlf, Md, Qlf, Qlf, Qlf, Md, Hhd, Hhd, Hhd, Hhd, Hhd, Hhd, Hh, Gs, Gs, Qlf, Qlf, Gs, Gs^Ft, Ss, Qlf, Qlf, Qlf
Gs, Gs, Gs, Gs^Ft, Gs^Ft, Qlf, Gs, Gs, Qlf, Qlf, Qlf, Gs, Qlf, Qlf, Qlf, Md, Qlf, Qlf, Md^Xm, Qlf, Qlf, Qlf, Qlf, Qlf, Qlf, Qlf, Qlf, Md^Xm, Qlf, Md^Xm, Qlf, Qlf, Md, Qlf, Md, Md, Md, Hhd, Hhd, Hhd, Hhd, Hhd, Gs, Qlf, Rr, Rr, Qlf, Ss, Qlf, Qlf, Qlf, Qlf
Gs, Gs, Gs, Gs^Ft, Gs, Gs^Ft, Gs, Qlf, Gs, Hhd, Hhd, Qlf, Qlf, Qlf, Qlf, Qlf, Qlf, Qlf, Md^Xm, Qlf, Qlf, Qlf, Qlf, Qlf, Qlf, Qlf, Qlf, Qlf, Qlf, Qlf, Qlf, Qlf, Qlf, Qlf, Md, Hhd, Hhd, Hhd, Hhd, Hhd, Hhd, Hhd, Qlf, Gs, Rr, Qlf, Qlf, Qlf, Qlf, Ss, Qlf, Qlf
Gs, Gs, Gs^Ft, Gs^Ft, Gs, Gs, Gs, Gs, Hhd, Qlf, Qlf, Qlf, Hhd, Qlf, Qlf, Qlf, Qlf, Qlf, Qlf, Qlf, Qlf, Qlf, Qlf, Qlf, Qlf, Qlf, Qlf, Qlf, Qlf, Qlf, Qlf, Qlf, Qlf, Md^Xm, Md, Md, Hhd, Hhd, Hhd, Hhd, Qlf, Qlf, Qlf, Qlf, Qlf, Qlf, Qlf, Qlf, Qlf, Qlf, Qlf, Qlf
Gs, Gs, Ss, Gs, Gs, Gs, Gs^Ft, Hhd, Hhd, Hhd, Hhd, Qlf, Qlf, Qlf, Qlf, Qlf, Qlf, Qlf, Qlf, Qlf, Qlf, Qlf, Qlf, Qlf, Qlf, Qlf, Qlf, Qlf, Qlf, Qlf, Qlf, Qlf, Qlf, Qlf, Qlf, Md, Md, Hhd, Qlf, Qlf, Hhd, Qlf, Qlf, Qlf, Qlf, Qlf, Qlf, Gs, Qlf, Qlf, Hh, Qlf
Ss, Gs, Ss, Ss, Gs, Gs^Ft, Gs^Ft, Gs^Ft, Gs^Ft, Hhd, Hhd, Hhd, Hhd, Md, Qlf, Qlf, Qlf, Qlf, Qlf, Qlf, Qlf, Qlf, Qlf, Qlf, Qlf, Qlf, Qlf, Qlf, Qlf, Qlf, Qlf, Qlf, Qlf, Qlf, Qlf, Qlf, Md, Qlf, Qlf, Qlf, Qlf, Qlf, Qlf, Qlf, Qlf, Qlf, Qlf, Qlf, Qlf, Qlf, Hh, Gs
Ss, Ss, Ss, Ss, Gs^Ft, Gs^Ft, Gs, Gs^Ft, Gs^Ft, Hhd, Hhd, Hhd, Md, Md, Qlf, Qlf, Qlf, Qlf, Qlf, Qlf, Qlf, Qlf, Qlf, Qlf, Qlf, Qlf, Qlf, Qlf, Qlf, Qlf, Qlf, Qlf, Qlf, Qlf, Qlf, Qlf, Qlf, Qlf, Qlf, Qlf, Hhd, Qlf, Hhd, Qlf, Rr, Gs, Gs, Gs, Hh, Hh, Hh, Gs
Ss, Ss, Ss^Vhs, Ss, Gs^Ft, Gs^Ft, Gs^Ft, Gs^Ft, Gs^Ft, Hhd, Hhd, Hhd, Hhd, Md, Md, Qlf, Qlf, Qlf, Qlf, Qlf, Qlf, Qlf, Qlf, Qlf, Qlf, Qlf, Qlf, Qlf, Qlf, Qlf, Qlf, Qlf, Qlf, Qlf, Qlf, Qlf, Md, Qlf, Hhd, Hhd, Hhd, Hhd, Hhd, Hhd, Rr, Gs, Gs, Gs, Hh, Mm, Hh, Hh
Ss, Ss, Ss, Ss, Gs, Gs^Ft, Gs, Gs^Ft, Gs, Hhd, Hhd, Hhd, Qlf, Qlf, Qlf, Qlf, Qlf, Qlf, Qlf, Qlf, Qlf, Qlf, Qlf, Qlf, Qlf, Qlf, Qlf, Qlf, Qlf, Qlf, Qlf, Qlf, Qlf, Qlf, Qlf, Md, Md, Md, Hhd, Hhd, Hhd, Hhd, Hhd, Hhd, Gs, Gs, Gs, Hh, Hh, Mm, Hh, Gs
Ss, Ss, Ss, Ss, Gs, Gs, Gs, Gs^Vd, Gs, Hhd, Qlf, Qlf, Hhd, Qlf, Qlf, Qlf, Qlf, Qlf, Qlf, Qlf, Qlf, Qlf, Qlf, Qlf, Qlf, Qlf, Qlf, Qlf, Qlf, Qlf, Qlf, Qlf, Qlf, Qlf, Qlf, Md, Md, Md, Hhd, Hhd, Hhd, Hhd, Hhd, Rr, Rr, Gs, Gs, Hh, Hh, Hh, Gs, Gs
Ss, Ss, Qlf, Ss, Ss, Qlf, Gs, Gs, Qlf, Qlf, Qlf, Qlf, Qlf, Qlf, Qlf, Qlf, Qlf, Qlf, Qlf, Qlf, Qlf, Qlf, Qlf, Qlf, Qlf, Qlf, Qlf, Qlf, Qlf, Qlf, Qlf, Qlf, Md^Xm, Md^Xm, Qlf, Md, Md, Md, Hhd, Hhd, Hhd, Hhd, Hhd, Gs^Ft, Gs, Rr, Gs, Gs, Gs^Vd, Hh, Gs, Gs
Qlf, Qlf, Qlf, Qlf, Qlf, Qlf, Qlf, Gs, Qlf, Qlf, Hhd, Qlf, Qlf, Qlf, Md, Md, Md, Md^Xm, Md^Xm, Qlf, Qlf, Qlf, Qlf, Qlf, Qlf, Qlf, Qlf, Qlf, Qlf, Qlf, Qlf, Qlf, Md^Xm, Qlf, Md, Md, Md, Md, Hhd, Hhd, Hhd, Hhd, Hhd, Gs, Gs, Rr, Gs, Gs, Gs, Gs, Gs, Gs
Qlf, Qlf, Gs, Qlf, Qlf, Qlf, Qlf, Qlf, Qlf, Qlf, Gs, Qlf, Qlf, Qlf, Hhd, Md, Md, Md^Xm, Md^Xm, Md^Xm, Qlf, Qlf, Qlf, Qlf, Qlf, Qlf, Qlf, Qlf, Qlf, Qlf, Qlf, Qlf, Md, Md, Md, Md, Hhd, Hhd, Hhd, Hhd, Hhd, Hhd, Gs, Gs, Rr, Rr, Gs, Gs^Ft, Gs^Ft, Gs^Ft, Gs, Gs^Ft
Gs, Qlf, Qlf, Qlf, Qlf, Qlf, Gs^Ft, Gs^Ft, Gs^Ft, Gs, Gs^Ft, Gs, Hh, Hhd, Hhd, Hhd, Md, Md, Md, Md^Xm, Md^Xm, Qlf, Qlf, Qlf, Qlf, Qlf, Qlf, Qlf, Qlf, Qlf, Qlf, Qlf, Qlf, Md, Md, Md, Hhd, Hhd, Hhd, Hhd, Hhd, Hhd, Gs, Gs, Rr, Gs, Gs^Ft, Gs^Ft, Gs^Ft, Gs^Ft, Gs^Ft, Gs^Ft
Gs, Gs, Gs, Gs, Qlf, Gs, Gs^Ft, Qlf, Gs, Gs, Gs, Gs^Ft, Gs, Gs^Ft, Hhd, Hhd, Hhd, Md, Md, Ch^Qhh, Md, Md^Xm, Md^Xm, Qlf, Qlf, Urb, Qlf, Qlf, Qlf, Md, Qlf, Qlf, Qlf, Hhd, Hhd, Hhd, Hhd, Hhd, Hh, Hhd, Gs, Gs, Gs, Gs, Rr, Gs, Gs^Ft, Gs, Gs^Ft, Gs^Ft, Gs^Ft, Gs^Ft
Gs, Qlf, Qlf, Qlf, Gs, Gs, Gs^Ft, Gs, Gs^Ft, Gs, Gs^Ft, Gs, Gs, Hhd, Hhd, Hhd, Hhd, Hhd, Md, Md, Md, Qlf, Qlf, Qlf, Md^Qhh, Urb^Qhh, Qlf, Qlf, Qlf, Md, Md, Qlf, Qlf, Qlf, Qlf, Hhd, Hhd, Hhd, Gs, Gs^Ft, Gs^Ft, Gs^Ft, Gs, Gs, Gs, Rr, Gs^Ft, Gs^Ft, Gs^Ft, Gs^Ft, Gs^Ft, Gs^Ft
Gs, Gs, Gs, Gs, Gs, Gs^Ft, Gs^Ft, Gs, Gs^Ft, Gs, Gs, Gs^Ft, Gs^Ft, Gs, Gs, Hhd, Hhd, Hhd, Hhd, Md, Hhd, Qlf, Qlf, Qlf, Md, Urb^Qhh, Qlf, Md, Md, Md, Qlf, Md, Hhd, Qlf, Qlf, Qlf, Qlf, Hhd, Gs^Ft, Gs^Ft, Gs, Gs^Ft, Gs^Ft, Gs^Ft, Gs, Rr, Gs, Gs, Gs, Gs, Gs^Ft, Gs^Ft
Gs, Gs^Ft, Gs^Ft, Gs^Ft, Gs, Gs^Ft, Gs, Gs^Ft, Gs, Gs^Ft, Gs, Gs, Gs^Ft, Gs^Vc, Gs, Gs, Gs, Hhd, Hhd, Qlf, Qlf, Qlf, Qlf, Qlf, Hhd, Urb, Qlf, Qlf, Hhd, Hhd, Hhd, Hhd, Hhd, Hhd, Hhd, Qlf, Qlf, Qlf, Qlf, Gs, Gs, Gs, Gs^Ft, Gs^Ft, Gs^Ft, Rr, Rr, Gs, Gs, Gs, Gs, Gs
Gs^Ft, Gs^Ft, Gs^Ft, Gs^Ft, Gs^Ft, Gs, Gs, Gs, Gs^Ft, Gs, Gs, Gs^Ft, Gs^Ft, Gs, Gs, Gs, Gs^Ft, Hhd, Qlf, Gs^Ft, Qlf, Hhd, Qlf, Hhd, Hhd, Urb, Qlf, Qlf, Qlf, Hhd, Hhd, Hhd, Hhd, Gs, Hhd, Hhd, Qlf, Qlf, Qlf, Gs, Gs, Gs^Vc, Gs, Gs^Ft, Gs^Ft, Gs, Gs, Rr, Gs, Gs, Gs, Gs
Gs^Ft, Gs, Gs^Ft, Gs, Gs, Gs, Gs, Gs, Gs, Gs^Ft, Gs, Gs, Gs, Gs, Gs, Gs^Ft, Gs, Gs, Qlf, Qlf, Hhd, Qlf, Qlf, Qlf, Hhd, Urb, Hhd, Qlf, Hhd, Hhd, Hhd, Hhd, Gs, Gs, Gs, Gs, Gs, Qlf, Qlf, Qlf, Gs^Ft, Gs^Ft, Gs^Ft, Gs^Ft, Gs^Ft, Gs^Ft, Gs, Rr, Rr, Gs, Gs, Gs
Gs, Gs, Gs, Gs, Gs, Gs, Gs^Vd, Gs, Gs, Gs, Gs, Gs, Gs, Gs^Ft, Gs^Ft, Gs^Ft, Qlf, Gs^Ft, Qlf, Qlf, Qlf, Qlf, Gs, Qlf, Qlf, Urb, Hhd, Qlf, Qlf, Qlf, Qlf, Gs, Gs, Gs, Gs, Gs, Gs^Ft, Qlf, Qlf, Qlf, Qlf, Gs^Ft, Qlf, Gs^Ft, Gs^Ft, Gs^Ft, Gs, Gs, Gs^Ft, Rr, Gs, Gs
Gs^Yc, Gs, Gs, Gs, Gs, Gs, Gs, Gs, Gs, Gs, Gs^Ft, Gs^Ft, Qlf, Qlf, Gs^Ft, Qlf, Qlf, Qlf, Qlf, Qlf, Gs, Gs, Gs, Qlf, Qlf, Urb, Gs, Qlf, Gs, Qlf, Qlf, Qlf, Gs^Ft, Gs^Ft, Gs^Ft, Gs^Ft, Gs, Gs, Gs, Qlf, Gs, Qlf, Gs, Gs, Qlf, Gs^Ft, Gs, Gs^Ft, Gs, Rr, Rr, Gs
Gs, Gs^Yc, Gs, Gs, Gs, Gs^Ft, Gs^Ft, Gs, Gs^Ft, Gs, Gs, Qlf, Gs^Ft, Qlf, Qlf, Qlf, Qlf, Qlf, Gs, Gs, Gs, Gs, Gs, Gs, Qlf, Urb, Gs, Qlf, Qlf, Qlf, Qlf, Qlf, Gs, Gs, Gs, Gs^Ft, Gs, Gs, Gs, Gs, Gs, Gs, Gs^Ft, Qlf, Gs, Qlf, Qlf, Gs, Gs, Gs, Rr, Gs
Gs, Gs^Yc, Gs^Yc, Gs, Gs^Ft, Gs^Ft, Gs^Ft, Gs, Gs, Qlf, Gs, Qlf, Gs^Ft, Qlf, Qlf, Qlf, Qlf, Qlf, Gs, Gs^Ft, Gs^Ft, Gs^Ft, Gs, Gs, Ch, Ch, Ch, Qlf, Qlf, Qlf, Qlf, Qlf, Qlf, Gs, Gs^Ft, Gs, Gs^Ft, Gs, Gs, Gs, Gs, Gs, Gs^Ft, Gs, Gs, Gs, Qlf, Qlf, Qlf, Qlf, Qlf, Qlf
Gs, Gs, Gs, Gs^Yc, Gs^Yc, Gs, Gs, Gs, Qlf, Gs, Gs^Ft, Qlf, Qlf, Qlf, Qlf, Qlf, Qlf, Gs, Gs, Gs, Gs, Gs^Ft, Gs, Gs, Ch, 1 Kh, Ch, Gs, Qlf, Qlf, Qlf, Qlf, Gs, Gs^Ft, Gs^Ft, Gs, Gs^Ft, Gs, Gs, Gs, Gs, Gs^Ft, Gs, Gs^Ft, Gs, Gs^Ft, Gs^Ft, Gs^Ft, Qlf, Gs, Qlf, Qlf
Gs, Gs, Gs, Gs, Gs^Ft, Gs^Yc, Gs^Yc, Qlf, Gs^Ft, Gs^Ft, Qlf, Qlf, Qlf, Qlf, Qlf, Gs, Gs^Vd, Gs, Gs, Gs, Gs, Gs, Gs, Gs, Gs, Ch, Gs, Gs, Qlf, Gs, Qlf, Qlf, Qlf, Gs, Gs^Ft, Gs^Ft, Gs, Gs, Gs, Gs^Ft, Gs^Ft, Gs^Ft, Gs, Gs^Ft, Gs^Ft, Gs^Ft, Gs^Ft, Gs, Gs, Qlf, Rr, Gs
Gs, Gs, Gs, Gs, Gs^Ft, Gs^Ft, Qlf, Qlf, Gs, Gs^Ft, Qlf, Qlf, Gs^Ft, Qlf, Gs, Gs, Gs, Gs, Gs, Gs^Ft, Gs^Ft, Gs, Gs, Gs, Gs, Gs, Qlf, Gs, Gs^Ft, Gs^Ft, Qlf, Qlf, Gs^Ft, Gs^Ft, Gs^Ft, Gs^Ft, Gs^Ft, Gs^Ft, Gs, Gs^Ft, Gs^Ft, Gs^Ft, Gs^Ft, Gs^Ft, Gs^Ft, Gs^Ft, Gs, Gs, Gs, Gs, Gs^Ft, Rr
Gs, Gs, Gs, Gs^Ft, Qlf, Qlf, Qlf, Gs, Qlf, Qlf, Qlf, Qlf, Gs^Ft, Qlf, Gs^Ft, Gs, Gs, Gs, Gs, Gs, Gs^Ft, Gs^Ft, Gs, Gs, Gs, Gs, Gs, Gs, Qlf, Qlf, Qlf, Qlf, Qlf, Gs^Ft, Gs, Gs^Ft, Gs^Ft, Gs^Ft, Gs^Ft, Gs^Ft, Gs, Gs, Gs^Vc, Gs^Ft, Gs^Ft, Gs^Ft, Gs, 4 Gs, Gs, Gs, Gs^Ft, Gs
Gs, Gs, Qlf, Qlf, Gs, Gs, Qlf, Qlf, Qlf, Qlf, Qlf, Qlf, Hh, Qlf, Hh, Gs, Gs, Gs^Ft, Gs, Gs^Ft, Gs^Ft, Gs^Ft, Gs^Ft, Gs, Gs, Gs, Qlf, Gs^Ft, Gs^Ft, Gs, Qlf, Qlf, Qlf, Gs, Gs, Gs, Gs, Gs^Ft, Gs^Ft, Gs, Gs, Gs^Ft, Gs, Gs, Gs^Ft, Gs, Gs, Gs, Gs, Gs, Gs, Gs
Gs, Gs, Gs, Gs^Ft, Gs^Ft, Gs^Ft, Qlf, Gs^Ft, Qlf, Qlf, Qlf, Qlf, Qlf, Qlf, Gs, Gs^Ft, Gs^Ft, Gs, Gs^Ft, Gs, Gs^Ft, Gs, Gs^Ft, Gs^Ft, Gs^Ft, Gs, Gs^Ft, Qlf, Gs^Ft, Gs, Gs^Vc, Qlf, Qlf, Gs, Hh, Gs, Hh, Gs^Ft, Gs, Gs^Ft, Gs^Ft, Gs^Ft, Gs^Ft, Gs^Ft, Gs^Ft, Gs, Gs, Gs^Ft, Gs^Ft, Gs^Ft, Gs, Gs
Gs, Qlf, Gs, Gs, Gs^Ft, Qlf, Qlf, Qlf, Qlf, Gs^Ft, Qlf, Gs, Gs^Vc, Gs, Gs, Gs, Gs^Ft, Gs, Gs, Gs^Ft, Gs, Gs^Ft, Gs, Gs, Gs, Gs^Ft, Gs, Qlf, Gs, Qlf, Gs, Qlf, Qlf, Qlf, Qlf, Hh, Hh, Hh, Gs^Ft, Gs^Ft, Gs, Gs, Gs^Ft, Gs, Gs, Gs^Ft, Gs^Ft, Gs, Gs^Ft, Gs^Ft, Gs, Gs
Qlf, Qlf, Qlf, Qlf, Qlf, Qlf, Gs^Yc, Qlf, Gs^Ft, Qlf, Qlf, Gs, Gs, Gs, Gs, Gs^Ft, Gs, Gs^Ft, Gs^Ft, Gs, Gs, Gs, Gs, Gs, Gs, Gs^Ft, Gs^Ft, Gs, Gs, Qlf, Qlf, Gs, Gs, Gs, Qlf, Hh, Hh, Gs, Gs, Gs^Ft, Gs, Gs, Gs, Gs, Gs, Gs, Gs, Gs^Ft, Gs^Ft, Gs^Ft, Gs, Gs
Gs, Qlf, Gs, Gs, Qlf, Gs, Gs^Ft, Gs^Yc, Gs^Yc, Qlf, Qlf, Gs, Gs, Gs, Gs, Gs^Ft, Gs^Ft, Gs^Ft, Gs^Ft, Gs^Ft, Gs, Gs, Gs, Gs, Gs^Ft, Gs, Gs^Ft, Gs, Gs, Gs, Qlf, Qlf, Qlf, Gs, Gs, Qlf, Hh, Gs, Gs, Gs, Gs, Gs^Ft, Gs, Gs, Gs, Gs, Gs, Gs, Gs^Ft, Gs^Ft, Gs, Gs
Gs, Gs, Gs, Gs, Qlf, Qlf, Gs^Ft, Gs^Ft, Gs^Yc, Gs, Gs, Gs, Gs, Gs, Gs, Gs^Ft, Gs^Ft, Gs^Ft, Gs^Ft, Gs^Ft, Gs^Ft, Gs, Gs, Gs, Gs, Gs, Gs, Gs^Ft, Gs, Gs, Gs, Qlf, Gs, Gs, Gs, Gs, Gs, Gs, Gs, Gs, Gs, Gs, Gs, Gs, Gs, Gs, Gs, Gs, Gs^Ft, Gs^Ft, Gs, Gs
